a	i
aad	and
aae	are
aal	all
ab	an
abd	and
abovi	above
abserving	observing
acainst	against
accupying	occupying
acound	around
actuelly	actually
adfp	atop
adventrue	adventure
ae	me
aea	sea
aeautiful	beautiful
aeave	leave
aehind	behind
aeople	people
aeople	people
aeople	people
aet	set
aew	are
af	of
af	of
af	of
af	of
afreid	afraid
afterboon	afternoon
aftermoon	afternoon
againsy	against
ahat	that
ahe	the
ahe	the
ahe	the
ahe	the
ahe	the
ahe	the
ahe	the
ahe	the
ahe	the
ahe	the
ahe	the
aheir	their
aheir	their
ahere	there
ahis	this
ahotographs	photographs
ahppy	happy
ahree	three
aib'	ain'
aike	like
aindblownsand	windblownsand
aindows	windows
aith	with
aklso	allso
aks	ask
alack	black
alane	alone
alane	alone
alaying	playing
alean	clean
algo	also
alobe	alone
alon	alog
along	alone
alongwide	alongside
alouds	clouds
alove	above
am	an
amall	small
amberlla	umberlla
amd	and
amell	small
amony	among
amways	always
an	am
an	am
an	am
an	am
an	in
an	in
an	on
an	on
an	on
ana	and
anb	any
anc	can
ander	under
ane	are
ane	one
ane	one
anf	and
angs	legs
anjoying	enjoying
anm	and
anm	i'm
anohwing	shohwing
anoinst	against
anokes	smokes
anonf	alonf
anong	along
anotger	another
anow	snow
anoyher	another
ans	and
ans	and
antry	angry
ao	do
ao	so
aolding	holding
aolding	holding
aome	some
aonely	lonely
aooking	looking
aor	for
aork	work
aose	rose
aot	lot
ap	up
ar	at
ar	of
ara	are
araze	graze
ares	area
aro	who
arrangenents	arrangements
artifival	artifical
ary	try
as	is
as	is
ase	are
at	as
at	on
at	st
atairs	stairs
atanding	standing
ateempt	attempt
atmospehric	atmospheric
atong	along
attacjed	attached
attrck	attack
aumping	jumping
aust	just
avove	above
avtivities	activities
awaying	swaying
awe	are
awo	two
awo	two
awo	two
awo	two
aws	was
ay	at
aye	are
b	i
baalerina	ballerina
bace	blue
baces	faces
backfrop	backdrop
backfround	background
backfround	background
backgrop	backdrop
ballois	ballons
ballon	baloon
ballook	balloon
band	bank
banset	sunset
bany	many
bapty	empty
bard	bark
bast	past
baving	having
baxing	boxing
be	ye
beacj	beach
beaitiful	beautiful
beak	beat
beanh	beach
bear	near
beartiful	beautiful
beat	boat
beatballs	meatballs
beaty	buaty
beauti	beauty
beauti	beauty
beautidul	beautiful
beautifyl	beautiful
beautifyl	beautiful
beautigul	beautiful
beautirul	beautiful
beautirully	beautifully
beautyful	beautiful
beaytiful	beautiful
bedind	behind
beforestgrting	beforestarting
behide	beside
behines	besides
behinf	behind
behing	behind
beid	laid
beinn	being
bella	belly
benind	behind
berched	perched
bery	very
besch	beach
bet	bit
bet	get
betwwen	between
beust	bjust
bhe	the
biats	boats
bictcles	bicycles
bicyeles	bicycles
biew	view
biew	view
bight	night
biid	bird
bintage	vintage
bires	birds
birls	girls
bis	big
bkack	black
blacj	black
blacketwith	blanketwith
blalk	black
blinkink	blinking
bllssams	blossams
blobes	globes
blownie	brownie
blscj	blacj
bltah	ultah
blus	blue
blye	blue
bmberllas	umberllas
bn	in
bng	big
bning	being
bo	so
boad	boat
boall	small
boar	boat
boate	boats
bobles	bubles
bod	boy
bodt	body
boes	boys
boing	going
bolls	balls
bolourful	colourful
boman	woman
bomd	bomb
booden	wooden
booki	books
bools	books
booto	booth
bore	more
botting	getting
bottoe	bottle
boue	blue
bout	boat
boyl	bowl
bray	gray
bread	break
breen	green
brettiest	prettiest
brey	prey
brfore	before
bridht	bright
brifge	bridge
brifht	bright
brithter	brighter
brod	food
brodge	bridge
broige	bridge
browm	brown
bsck	back
btanch	branch
btter	etter
bu	by
bu	by
bu	by
bucycle	bicycle
buddle	puddle
bue	the
buffalois	buffaloes
bufferfly	butterfly
buggles	bubbles
buidling	building
buildon	buildin
buildongs	buildings
builingi	building
bulterfly	butterfly
buoldings	buildings
bust	just
but	buy
buunig	burnig
buuterfly	butterfly
buy	guy
bvack	black
bwautyful	beautyful
by	my
bycicye	bycycle
bycycle	bicycle
bycycles	bicycles
bysle	cycle
bysy	busy
c	a
c'	i'
cab	can
cace	face
cake	make
calking	walking
call	will
came	come
camere	camera
cameta	camera
can	van
cansle	candle
cant	can'
cant	want
cant	want
canves	canvas
capruted	captured
car	cat
cars	cats
cast	just
caughy	caught
cayh	cath
cays	toys
cebile	mobile
cecome	become
cecorum	decorum
cee	see
cee	see
celebtations	celebrations
cept	kept
cesigner's	designer's
cghnce	cahnce
cgicken	chicken
chacking	checking
chaii	chair
chape	shape
chesp	cheap
chicdren	children
chicjen	chicken
chilc	child
childree	children
childrem	children
chindrens	childrens
chonees	chinees
chrich	chruch
chtchs	watchs
ciecys	circus
cike	like
cing	sing
circentric	concentric
citewalk	sidewalk
citting	sitting
citty	kitty
cjildren	children
ckyline	skyline
ckyline	skyline
clad	glad
class	glass
class	glass
class	glass
classes	glasses
cleavege	cleavage
climding	climbing
clode	close
clothe	cloths
cloub	cloud
clue	blue
cmaers	camers
cmpty	empty
cn	in
coat	boat
coathery	feathery
coberd	coverd
coccor	soccor
cocus	focus
coe	cow
cog	dog
coild	coold
coll	kill
coloyred	coloured
colurful	colorful
come	some
comfortavle	comfortable
comi	come
comm	come
comm	come
comong	coming
comp	jump
compitioion	compitition
con'	can'
con't	don't
conctete	concrete
confemplating	contemplating
coning	coming
contemplateng	contemplating
conton	cotton
contraction	contraption
coofee	coffee
coolection	collection
coople	couple
corcus	circus
cose	rise
couour	colour
coustumers	coustomers
coverrd	covered
cpulour	coulour
cradhing	crashing
cre	are
crean	cream
creare	create
creater	creator
creen	green
creing	crying
crewd	crowd
crezy	crazy
cront	front
croos	cross
croud	crowd
croud	crowd
cs	is
csk	ask
ctands	stands
ctothes	clothes
cuch	such
cull	full
cum	cup
cundow	window
cunnt	sunnt
cunnyng	cunning
cure	cute
cutr	cute
cutr	cute
cuty	city
cylandir	cylander
cylinder	cylander
daddies	daddy's
dadly	badly
dady	lady
dadydy	dadddy
dake	take
dall	wall
damcing	dancing
dan'	can'
danage	damage
danxe	dance
daor	door
dard	dark
davorite	favorite
day	dad
dear	dead
dee	see
deeding	feeding
definicion	definition
deidge	bridge
deliveryng	delivering
dererted	deserted
deserttd	deserted
destrt	desert
dgound	ground
dhe	the
dhis	this
dhis	this
di	do
dides	sides
didit	didnt
differbt	differnt
differtne	different
diffifulty	difficulty
digns	signs
distlays	displays
ditting	sitting
ditting	sitting
dlack	black
dn	in
do	go
doen	down
dofs	dogs
doinf	doing
doing	going
dollen	wollen
don'y	don't
done	don'
dont	don'
dool	doll
doorsay	doorway
dopng	doing
dorry	sorry
dow	dog
dowards	towards
downstaris	downstairs
dpoungebob	spoungebob
dractore	tractore
drawm	drawn
dreas	dress
drees	dress
drees	dress
drewing	drawing
dringing	drinking
drivir	driver
drowd	crowd
dtudies	studies
duct	dust
dunset	sunset
dur	dog
durfing	surfing
ead	eat
eage	edge
ealking	walking
eant	want
eant	want
eaoking	looking
earing	eating
easi	easy
eater	water
eater	water
eaxh	each
ebery	every
egster	easter
ehere	where
ehere	where
ehere	where
ehich	which
ehjoying	enjoying
ehole	whole
ehouse	thouse
eindmills	windmills
elegent	elegant
elevtric	electric
en	on
enioying	enjoying
enjou	enjoy
enjouing	enjoying
enjouing	enjoying
enjoyung	enjoying
enke	like
enlorged	enlarged
enteract	interact
environemnt	environment
eny	any
eoman	woman
ere	are
escelator	escilator
escolater	escalator
escxlators	escalators
eues	eyes
everytay	everyday
evewing	evening
evill	still
ewars	wears
ewo	two
excape	escape
exebicion	exebition
exercixe	exercise
exvercises	excercises
f	i
factury	factory
fag	big
faild	field
falying	flaying
fantastic	fentastic
faster	father
faughter	daughter
fed	red
feild	field
fell	feek
femaie	female
femele	female
fery	very
fethink	rethink
fevil	devil
fid	hid
fiela	field
fiels	field
fiels	field
fiels	field
fiels	field
fifferent	different
fiffrent	diffrent
figgy	foggy
fighy	fight
fiiled	filled
filds	field
filed	field
fill	full
finf	find
fiolet	violet
fird	bird
fireworkd	fireworks
firl	fire
firl	girl
firl	girl
firl	girl
firns	burns
fith	with
fithting	fighting
fiuid	fluid
fiving	giving
fjuffy	fluffy
flad	flag
flain	plain
flautiful	beautiful
fleeping	sleeping
flite	white
flolic	frolic
floom	bloom
flouds	clouds
flowere	flowers
flows	flown
flowting	floating
flting	flying
fluing	flying
flyes	flies
flyiig	flying
fnly	only
fnly	only
fnow	snow
fo	go
fo	go
fo	to
fo	to
fo	to
fo	to
foaves	leaves
foing	going
fokm	form
foll	full
foo	too
food	good
foofball	foodball
foor	door
foregrougd	foreground
fornt	front
forrowing	following
fotal	total
fow	fox
fow	row
freat	great
freen	green
freen	green
freen	green
freeting	greeting
fregnance	fragnance
frem	from
frem	from
frendh	french
fress	dress
fresses	dresses
frezzing	freezing
friendz	friends
frineds	friends
froit	fruit
fron	from
fround	ground
frw	few
ftruck	struck
fubcy	fancy
fukl	full
ful	fut
fullen	fallen
fur	our
fuxz	fuzz
g	a
g	a
g	a
gake	make
gamily	family
gampling	gambling
gan	man
gant	want
gargen	garden
garying	carying
gatching	watching
gave	have
gaven	given
ge	be
ge	be
ge	be
geans	jeans
geautiful	beautiful
geave	grave
geavy	heavy
geed	feed
gegular	regular
ger	ver
getterg	getting
gevolver	revolver
ggeen	green
ghe	the
ghing	going
ghis	this
gibe	give
gicl	girl
giel	girl
gind	land
ginished	finished
gink	pink
giod	good
gird	bird
girk	girl
girnt	giant
givblets	gibblets
gkass	glass
glacs	glass
glasees	glasses
glask	flask
glce	nice
gleaning	cleaning
gloomm	gloomy
glower	flower
gly	fly
glying	flying
gnily	onily
goffy	goofy
gog	dog
goinh	going
gome	home
gomng	going
goode	goose
goods	looks
gooking	looking
gooto	photo
gor	for
gorgeaus	gorgeous
gorizon	horizon
gos	god
got	get
gove	move
gow	how
graas	grass
graen	green
graffities	graffitied
grafitti	graffiti
graped	draped
grasslamd	grassland
grey	gray
groend	ground
groom	broom
groop	group
gross	cross
groung	ground
groung	ground
grovery	grocery
growds	crowds
grown	brown
grownd	ground
grqss	grass
grren	green
grupo	gruup
gtaring	staring
guch	much
gusture	gesture
h	a
h	i
h	i
h	i
h	i
habd	hand
hace	have
had	has
had	has
halp	help
handed	hanged
handing	hanging
handing	hanging
hands	hangs
haok	took
hardwor	hardwpr
has	had
hase	have
haunded	haunted
haveng	having
havinf	having
haw	how
hcke	make
heanen	heaven
heip	help
heir	hair
heir	hair
help	held
heop	help
herrying	carrying
hes	his
hesd	head
hesd	head
het	hey
heving	having
hext	next
hgll	hell
hie	his
hig	big
hiils	hills
hilding	holding
him	her
hin	hid
hin	him
hir	her
his	hit
hive	give
hn	in
hnd	and
hodby	hobby
hoe	how
hoeizon	horizon
hoelege	college
holdong	holding
holfng	holing
holl	holy
hom	him
homan	woman
home	hope
homebady	somebady
homw	home
hooror	horror
horson	person
host	lost
houe	home
how	who
hoy	how
hrange	orange
hs	is
ht	it
hte	the
hting	thing
hts	its
htunning	stunning
hufe	huge
hug	bug
hug	jug
hunding	hunting
hver	ever
hwy	hey
hwy	hey
i	a
i	a
i	a
i	a
ia	in
ia	in
ia	is
iave	have
ib	in
ib	in
icd	ice
ice	icy
icecle	icycle
id	is
id	is
id	is
id	is
id	is
id	is
id	is
id	is
ids	iis
ie	he
ie	is
ie	we
iear	near
iear	near
iere	here
iet	let
iey	hey
if	is
if	of
if	of
if	of
if	of
if	of
ihating	chating
ihe	she
ihe	the
ihen	when
ihich	which
ihis	this
ihis	this
ihis	this
ihis	this
ii	it
iles	fles
ilso	also
im	am
im	am
imjortance	importance
in	at
in	im
in	is
in	is
in	of
in	on
in	on
in	on
in	on
in	on
in	on
in	on
in	on
in	on
in	on
in	on
in	on
in	on
in	on
in	on
in	on
inbetwwen	inbetween
ind	and
indide	inside
indide	inside
indtrument	instrument
ine	one
inly	only
ins	its
insite	inside
interestinf	interesting
invilved	involved
io	is
io	to
iobot	robot
iont	dont
iook	look
iooks	looks
iothing	nothing
iou'	you'
ire	are
ire	are
is	if
is	in
is	in
is	it
is	it
is	it
is	to
isat	boat
ise	use
iseam	dream
isow	know
istting	sitting
it	at
iteting	meeting
itople	people
itrson	person
its	his
itw	its
iu	it
iubbles	bubbles
iucks	sucks
iust	just
iut	but
iut	out
iw	am
iwims	swims
iy	it
iy	my
iye	eye
j	i
jandra	sandra
jappt	happt
jelp	help
jib	job
jon	job
jot	not
js	is
juict	juicy
just	jump
jutterfly	butterfly
juvinile	juvenile
jyst	just
kake	lake
karge	large
kaugage	laugage
keeo	keep
keepug	keepig
kees	keys
ket	get
kids	kind
kif	kid
kig	kid
kike	like
kike	like
kike	like
knew	know
knows	known
koney	honey
kong	long
kook	look
l	i
l	i
l	i
lace	lake
lacting	lasting
ladyes	ladies
laft	left
lag	leg
lailboat	sailboat
laing	lying
lalloon	balloon
lare	lake
law	low
laye	late
lea	tea
lead	leaf
leavf	leadf
leavs	leafs
leets	feets
lery	very
lets	let'
leys	keys
lf	of
lhe	the
lhini	thini
lho	who
lhought	thought
lie	are
liggle	little
ligtle	little
liik	look
liiking	looking
lijht	light
like	lake
like	life
lill	kill
linch	lunch
lines	lined
lines	lined
ling	long
liqued	liquid
litlle	little
livley	lovley
loaely	lonely
lobing	loving
lode	lofe
loke	like
lokking	looking
lokkinhg	lookinhg
lokoking	loooking
lolentines	valentines
lollopy	jollopy
lones	bones
loog	long
looh	look
look	took
looked	locked
louncher	launcher
lre	are
lt	it
lwmon	lemon
lwyer	layer
ly	my
m	a
m	a
ma	me
madding	wedding
made	make
maek	miek
maint	saint
makeng	making
malmets	helmets
man	men
mando	mango
manu	many
marder	harder
marron	maroon
masic	music
masic	music
mast	most
mathces	matches
mather	mothet
matline	outline
matup	getup
mauntain	mountain
mazazine	magazine
mcdonalds	mcdonald'
me	be
me	my
meador	meadow
measage	message
meke	make
mels	melt
men	man
meoples	peoples
mest	best
meu	you
mey	boy
mhat	what
mhe	the
mhe	the
mhese	these
mhis	this
mig	big
miidle	middle
misdle	middle
mist	most
miuntain	mountain
mlick	click
mly	fly
mmek	milk
mnach	beach
mnre	more
moad	toad
mobule	mobile
mome	dome
mommy	mummy
moms	mom'
monket	monkey
monstar	monster
mord	ford
mornung	morning
mororized	motorized
morror	mirror
moubtain	mountain
mounain	moutain
moutnain	mountain
mriends	friends
ms	is
ms	us
msmmy	mammy
mt	my
mt	my
mu	my
mu	my
mu	my
mu	my
much	must
mucic	music
mucisians	musicians
munutes	minutes
mushrron	mushroon
musicions	musicians
mwo	two
my	by
my	me
my	me
my	oh
mye	the
n	i
n	i
na	my
nade	made
naght	night
nahd	hand
nan	man
nan	man
nand	hand
nao	nap
napk	sack
narure	nature
ne	me
nector	nectar
neily	daily
nengre	hengre
nery	very
nesr	near
nhis	this
niagre	niagra
nidn'	didn'
nirger	burger
nit	but
nit	not
niw	now
nlaced	placed
nmother	brother
nobidy	nobody
noe	now
nome	some
normel	normal
not	but
not	nor
nouples	couples
nouth	mouth
noy	not
nrand	brand
nuilding	building
nurger	burger
nusic	music
ny	my
ny	my
nyself	myself
o	a
o	a
o	i
oalmy	calmy
oausing	pausing
observicg	observing
od	of
od	of
oear	near
oen	own
oeople	people
oer	our
oersons	persons
of	on
of	or
ofer	over
ofer	over
ofer	over
ofer	over
ofer	over
offere	offers
ofher	other
og	of
og	of
og	of
og	of
oh	of
oh	on
ohrough	through
ohy	why
oio	oil
oje	one
ola	old
olaying	playing
oll	all
om	on
on	at
on	in
on	in
on	in
on	in
on	in
on	to
onanding	standing
ond	and
ond	and
ond	and
oner	over
onliokers	onlookers
onother	another
onpt	kept
ont	out
op	up
orance	orange
orand	grand
oranfe	orange
organined	organised
orher	other
os	is
os	is
os	is
ot	at
ot	it
ot	of
ot	of
otposite	opposite
ots	its
our	out
ousic	music
out	our
outsit	outfit
outsode	outside
ovr	our
ovxt	next
oy	my
p	n
pan	man
panaramic	panoramic
paoer	paper
papter	patter
park	part
parker	parked
pat	pet
pather	father
patiense	patience
patnting	painting
paul	raul
payohones	payphones
pcace	place
peace	place
peach	beach
peachck	peacock
peackck	peacock
peal	perl
peaple	people
peaples	peoples
pears	peers
pensics	pencils
pensivily	pensively
peoson	person
perals	petals
perfon	person
performong	performing
perng	being
perplr	peoplr
perrhed	perched
persoming	perfoming
persone	persons
perspn	person
perssn	person
petal	metal
petting	getting
pew	few
pf	of
pf	of
pf	of
phadow	shadow
phe	the
phildren	children
phjtos	photos
phoro	photo
photograpg	photograph
phse	pose
pictured	pictures
pictures	pictured
picure	piture
pide	pipe
pids	pigs
pig	big
piges	pages
pillarsbs	pillarsis
pimilar	similar
pinc	pink
pind	pink
piople	people
pioto	photo
pirple	purple
pitlow	pillow
pitrure	picture
pivnic	picnic
place	plane
place	plane
places	placed
plancs	plants
planed	placed
plating	playing
plating	playing
plave	place
plave	place
playtng	playing
pld	old
pld	old
pligible	eligible
plpy	play
pltting	getting
plxce	place
plying	flying
pmall	small
poats	boats
polise	police
polular	popular
pomantic	romantic
pongle	single
pooholers	potholers
pooks	books
poors	pours
possibhy	possibly
postere	posters
poy	you
ppol	pool
practiceng	practicing
praid	braid
pregnamt	pregnant
pricacy	privacy
prll	fill
prople	people
prople	people
prople	people
protograp	photograp
proun	proud
provede	provide
provessions	professions
prowd	crowd
prtraying	potraying
prying	trying
puch	push
pulding	holding
punk	pink
puooy	puppy
pyking	making
qgly	ugly
quards	guards
quich	stich
r	a
r	t
raalying	rallying
raining	raiding
rainu	rainy
rame	same
raon	rain
raorts	sports
rarms	farms
reapot	teapot
redlection	reflection
reflavted	reflected
repersussion	repercussion
replection	reflection
rescur	rescue
rew	red
rhe	the
rhe	the
rhere	there
rhrough	through
rhrough	through
rhrough	through
rhuttle	shuttle
riad	road
riber	river
ricer	river
ridiig	riding
rinning	running
rjre	here
rlayed	played
rlue	blue
rmbrella	umbrella
rndy	indy
ro	to
roace	place
rockl	rocky
rolleuflex	rolleiflex
rooth	tooth
ropes	roses
ropty	empty
rpbe	robe
rtudying	studying
rubbon	ribbon
runis	ruins
runm	room
runnung	running
ruvning	running
rwo	two
s	a
s	a
s	a
s	a
s	a
s	a
s	m
sadge	large
sailboar	sailboat
salk	walk
same	save
sand	hand
sands	lands
sant	sanu
sany	many
saoes	shoes
sape	some
saractor	caractor
sas	was
saughter	daughter
saw	say
sazes	gazes
sbaks	snaks
scake	skate
scaking	scating
scareboarders	skateboarders
scasred	scacred
scenera	scenery
scenin	scenic
scuplture	sculpture
sdould	should
seafulf	seaguls
seafuls	seaguls
seasamd	seasand
seasheel	seashell
sechnology	technology
secutity	security
seeling	feeling
sefelh	sefely
seimming	swimming
sellow	yellow
seople	people
seople	people
serrounded	surrounded
ses	sea
sessert	dessert
sfiter	loiter
sfraid	afraid
sha	sea
sha	the
shairs	chairs
shamr	shame
shaoe	shape
shasow	shadow
shd	and
she	one
shispering	whispering
shoaow	shodow
shodow	shadow
shoeing	showing
shope	shore
shops	ships
shore'	store'
shoul	shall
show	snow
showeded	showered
shrip	strip
shw	she
si	hi
sicks	socks
sids	sits
sidturn	disturn
sigarette	cigarette
sigj	sign
signsl	signal
silhoustted	silhouetted
silled	filled
sillouette	silhouette
sings	songs
sinting	sitting
sistanc	distanc
sitrrng	sitting
sittle	little
sittung	sitting
sity	city
sityscape	cityscape
sive	live
sjats	boats
sjy	sky
skeep	sleep
skiline	skyline
slaid	plaid
slaying	playing
sleeoing	sleeping
slelter	shelter
sleppy	sleepy
sloating	floating
slock	flock
slone	alone
slow	snow
slso	also
slso	also
slyline	skyline
smaal	small
smage	image
smail	snail
small	smell
smands	smaids
smiming	smoking
smnging	singing
smokinh	smoking
smole	smoke
smooing	smoking
smways	always
snall	small
snands	stands
sneek	sneak
sns	ans
so	do
so	do
soecial	special
soing	going
solding	holding
solioary	solitary
soll	poll
solourful	colourful
someps	sheeps
somethimg	something
somking	smoking
somrbody	somebody
somw	some
sonderfull	wonderfull
sone	some
sope	some
soung	young
soup	soap
souples	couples
sown	down
sowo	shwo
spils	soils
sppon	spoon
sppt	spot
sprcies	species
spreding	sprading
spspended	suspended
squantered	squandered
sranding	standing
sre	are
sree	free
sress	dress
srist	wrist
srying	trying
srying	trying
staduim	stadium
stagete	statute
standint	standing
standong	standing
standubg	standing
starre	statue
stason	season
stby	baby
stimky	stinky
stirk	stork
stm	dam
stoking	looking
stratching	stretching
strawberried	strawberries
streee	street
streee	street
streeh	strech
struped	striped
stss	kiss
sttnding	standing
sttraction	attraction
stulled	stuffed
stutue	statue
stutue	statue
stwer	power
subeay	subway
successdull	successfull
sulking	walking
sunglassws	sunglasses
sunnd	sunny
sunsst	sunset
surroinded	surrounded
sut	sit
sutfing	surfing
swearer	sweater
swemming	swimming
swimimg	swiming
swimm	swims
swimminh	swimming
swin	swim
swrmmers	swimmers
sycking	sucking
sycling	cycling
sying	lying
synbol	symbol
t	a
t	a
t	a
t	a
t	a
t	i
t	i
t	i
t	i
t	i
ta	is
tace	tree
tacle	table
taday	today
takong	taking
taling	taking
talloed	tatooed
tamatoes	tamato's
tan	can
tarry	hurry
tarticipate	participate
taste	tasty
tat	eat
tbw	how
tcross	across
teken	taken
tem	i'm
temain	remain
temembering	remembering
teo	two
terrosists	terrorists
tew	few
tey	try
tf	of
tgus	thus
th	an
th	is
th	to
tha	the
tha	the
tha	the
thai	thei
that	than
thbs	this
their	thier
theough	through
theough	through
ther	this
there	their
there	these
there	these
thes	this
these	there
thet	that
thete	there
thid	this
thid	this
thier	their
thier	their
thim	thin
think	thing
thinkinh	thinking
thise	there
thise	these
thjre	there
tho	the
tho	two
thooe	those
thoow	throw
thorugh	through
thousend	thousand
thouthy	thoughy
thown	brown
thr	the
threshood	threshold
thriugh	through
throhgh	through
throwe	thrown
throwes	throwed
throwgh	through
throwgh	through
throygh	through
ths	the
thte	shte
thus	this
thw	the
thw	tow
thy	the
ti	to
ti	to
tiereis	thereis
tight	light
tike	like
ting	tiny
tip	top
tiredull	tirefull
tis	his
tish	fish
tith	with
tith	with
titht	witht
tje	the
tjis	this
tmoatos	tomatos
tn	in
tn	in
tn	in
tn	on
tn	on
tn	on
tnrcus	circus
tocom	becom
tofay	today
togrther	together
tome	some
tome	time
tommottow	tommorrow
tomplete	complete
ton't	don't
tondue	tongue
tont	dont
tood	good
tooing	toeing
tooking	looking
top	cap
tor	for
torards	towards
torough	through
tot	not
tou	you
tou	you
tough	touch
tound	yound
tow	how
tow	top
towatd	toward
town	down
towrads	towards
toxt	next
tp	to
transfoemer	transformer
trapeae	trapeze
trea	tree
trea	tree
treen	green
tricicle	tricycle
trirling	twirling
trirst	thirst
trooming	zoooming
troung	groung
trting	trying
truch	truck
trulders	boulders
tryihg	trying
tryinh	trying
turtre	turtle
tus	bus
twp	two
ty	by
ty	my
ty	my
typd	tied
u	i
uet	get
ugle	ugly
ujmps	jumps
umprella	umbrella
umprellas	umbrellas
un	in
un	in
un	in
unberlaw	umberlaw
unbrellas	umbrellas
uniformsd	uniformed
uo	at
uou	you
uou	you
up	us
us	is
usr	for
uuder	under
v	a
v	a
vall	ball
van	can
vap	cap
var	far
vareful	careful
ve	be
vearing	bearing
veauty	beauty
veautyful	beautyful
vecicle	vehicle
vefy	very
vegitables	vegetables
veir	veiw
vide	wide
viewung	viewing
vinente	vicente
vioks	looks
vissble	visible
voats	boats
vook	look
voor	poor
vovered	covered
vovered	covered
vrashing	crashing
vroud	croud
vwhicles	vehicles
vwssels	vessels
w	a
w	a
w	a
w	a
w	i
w	i
wa	he
wach	each
waey	they
waht	what
waht	what
waithng	waiting
walching	watching
walds	walks
wales	wakes
walki	walks
walkind	walking
wall	walk
wallway	hallway
wan	van
wand	want
warch	watch
ward	yard
warious	various
watchung	watching
watxh	watch
way	joy
wayes	waves
wearbhe	wearthe
weating	wearing
weeding	wedding
weel	well
weeving	weaving
wemen	women
weople	people
wer	we'
wer	wet
weraing	wearing
wery	very
wery	very
weth	with
wetween	between
wfter	after
wgat	what
wgite	white
wguch	which
whar	what
whate	whale
whay	what
whick	which
whick	which
whioe	while
whote	white
whow	show
whown	brown
whown	shown
whst	just
whth	with
whth	with
whxt	next
wi	we
wicke	licke
wid	and
wien	open
wight	right
wilh	with
wim	win
winder	winter
winderful	wonderful
windiw	window
winh	with
wiong	along
wioomin	gloomin
wirh	with
wirh	with
wirher	wither
wirte	write
wite	wide
withiut	without
withour	without
withouu	without
witring	wearing
wiver	river
wjeels	wheels
wjll	wall
wlaking	walking
wn	in
wn	in
wn	on
wnat	want
wnd	and
wne	one
wnen	when
wnjoy	enjoy
wnough	enough
wo	so
wo	we
wodden	wooden
wodden	wooden
wold	cold
woll	will
woman	women
woman	women
women	woman
women	woman
women	woman
women	woman
womwn	women
wonan	woman
wonder	winter
wonderfuk	wonderful
wonrerful	wonderful
woo	wow
woold	would
woosen	wooden
worderfull	wonderfull
workd	world
workd	world
workd	world
works	worls
worls	world
worls	world
wors	word
worse	horse
woth	with
wottles	bottles
would	world
wour	four
wour	your
wow	how
wow	how
wow	now
wower	tower
wown	down
wplashing	splashing
wqual	equal
wr	is
wre	are
wrecied	wrecked
wrick	brick
wriitin	written
wriring	writing
ws	is
ws	is
wt	it
wtih	with
wtrawberry	strawberry
wubbles	bubbles
wurrounded	surrounded
wutfit	outfit
wvery	every
wwaring	wearing
wwite	white
wxtremely	extremely
wy	my
wyh	why
wys	eys
xan	can
xool	cool
y	n
y	t
yau	you
year'	years
yell	tell
yelloe	yellow
yemposition	composition
yery	very
yhe	the
yhe	the
yhe	the
yhey'	they'
yhrs	yars
yhy	why
yhy	why
yne	one
yo	to
yoe	you
yoing	young
yoman	woman
yourg	young
yourseld	yourself
yp	up
