dhe	the
olso	also
stx	six
cont	dont
peopla	people
eith	with
af	of
miuntain	mountain
junping	jumping
perdon	person
tain	rain
dhink	think
plue	blue
awo	two
neightors	neighbors
there	theie
exoerience	experience
anoyher	another
attrck	attack
bysycle	bicycle
hoe	are
bib	big
w	a
iehind	behind
boars	boats
wou	you
isd	iss
bice	nice
santaclouse	santaclause
peacticing	practicing
swiminh	swiming
mriends	friends
soes	does
doker	joker
sore	more
toich	which
an	st
muxt	must
yhe	the
lhow	show
thenk	thank
won	win
somethinh	something
whith	white
attacjed	attached
eatars	eaters
liik	look
ditch	dutch
iromt	fromt
flyinh	flying
skaeer	skater
bnd	and
standino	standing
tried	tired
that	than
forgs	frogs
weth	with
class	glass
whote	white
talking	walking
bn	in
gress	grass
poece	piece
gold	golf
cacing	racing
salois	salors
ere	are
oue	our
ma	my
vechilk	vechile
mushc	music
crave	grave
ond	and
more	some
fransisco	francisco
catrying	carrying
geople	people
on	by
plancs	plants
cunnt	sunnt
along	alone
thise	those
iut	out
gink	pink
rar	car
liver	river
onch	each
wjth	with
folored	colored
viooet	violet
booto	booth
teachp	teacup
souples	couples
uy	my
natyre	nature
muoungebob	spoungebob
michophone	microphone
glying	flying
tf	of
starning	starving
mani	many
snall	small
ahe	the
illumnited	illumnated
berrie	berry'
comw	come
holdind	holding
pusic	music
foing	doing
cvntaining	containing
ihis	this
liggle	little
sooden	wooden
he	me
carefylly	carefully
poor	pool
ar	am
wonen	woman
dird	bird
clotehs	clothes
farkness	darkness
a	s
bhoto	photo
amd	and
miised	missed
eitdown	sitdown
hell	hill
willd	would
ao	to
kmow	know
undergroung	underground
lollow	follow
trt	got
ny	my
optside	outside
laing	lying
willed	filled
majes	makes
bevely	lovely
ti	to
kaking	making
ge	cn
commpng	comming
to	so
dire	more
eaen	even
shven	seven
liguid	liquid
surreunds	surrounds
buddle	bubble
kinling	killing
cysle	cycle
bow	now
ot	it
hwy	hey
treea	trees
hice	nice
jood	good
lets	let'
ncie	nice
uou	you
smimming	swimming
edcellent	excellent
barked	parked
dor	for
provided	providin
cer	car
maching	machine
fparkler	sparkler
waoks	looks
on	by
eveb	even
lifw's	life's
eill	will
ma	me
photofraph	photograph
af	of
iy	my
shirt	short
siti	sits
finidhed	finished
walkiig	walking
there	these
afain	again
bat	eat
haking	waking
withour	without
onrs	cars
in	on
dud	due
ssid	said
nong	long
us	is
py	my
greem	green
damous	famous
jumo	jump
od	of
buiscuit	biuscuit
hoe	how
wome	some
ss	so
candkes	candles
theyer	therer
dlong	along
whiel	wheel
lre	are
eldeely	elderly
derty	dirty
thet	that
qll	all
dysplayed	displayed
in	on
packed	parked
somrist	tourist
rid	red
goft	gift
oink	pink
sust	must
brom	from
tou	you
propably	probably
sids	sits
wi	we
smake	smoke
adhire	adhere
pype	type
goina	going
fives	gives
ny	by
perplr	peoplr
expanxe	expanse
outique	antique
tail	rail
iear	near
fump	jump
huiet	quiet
magisian	magician
wlak	walk
chat	that
zwimming	swimming
mu	my
forus	focus
fround	ground
ter	her
solorful	colorful
me	be
yhe	the
issetting	issitting
golding	holding
wre	are
hanfings	hangings
beddoom	bedroom
care	cars
man	men
chik	chil
bootom	bottom
reats	seats
fo	to
maig	many
natire	nature
restubg	resting
salks	walks
icecle	icycle
ruses	rises
plave	place
marsons	persons
berd	bird
cery	very
cenemony	ceremony
pkier	skier
lvke	like
ans	and
onying	flying
pisition	position
lont	dont
oranged	oranges
dhe	the
yo	to
zi	hi
couky	rocky
wook	wood
floerds	flowers
sugarg	sugary
blosomes	blosomed
bycycle	bicycle
verety	vaiety
beatuful	beatiful
hirse	horse
ihis	this
mymmy	mummy
anf	and
toe	the
og	of
rianboots	rainboots
cecret	secret
aftica	africa
momen	women
hio	hit
waining	waiting
hoter	hotel
seading	reading
ihatever	whatever
diffenent	different
jnoe	knoe
wgite	white
bature	nature
butterely	butterfly
bigwn	brown
plcling	cycling
in	on
silled	filled
ta	is
aricks	tricks
ceremomr	ceremomy
arnjucted	conjucted
sunsst	sunset
isaring	wearing
wrinking	drinking
arranded	arranged
an	on
hery	very
rifing	riding
beautuful	beautiful
lonelu	lonely
cdults	adults
cont	dont
ezperience	experience
bot	lot
wery	very
bbys	boys
croud	crowd
ppol	pool
jib	job
thes	this
freat	great
erown	brown
ialm	calm
og	of
ffiend	friend
decoravive	decorative
berore	before
dide	ride
tor	for
sot	hot
beautoful	beautiful
ewn	own
lioking	looking
tee	see
vsed	used
parloue	parlour
staduim	stadium
is	in
buildongs	buildings
aut	out
ahree	three
anandoned	abandoned
ceychain	keychain
brifht	bright
smow	snow
sailiog	sailing
froends	friends
tight	right
builging	building
rew	few
thjre	there
gleaning	cleaning
manantain	maiantain
groung	ground
sustbin	dustbin
baxing	boxing
seas	seat
velebrating	celebrating
drees	dress
mord	ford
bet	bed
cor	gor
namkin	napkin
alaying	playing
sereral	several
hesd	head
whth	with
umprella	umbrella
foing	going
freinds	friends
un	in
commecting	connecting
escxlators	escalators
peiple	people
lines	lined
iow	how
sw	to
supoosd	supooed
encouraghd	encouraged
funcrion	function
opject	object
la	it
sppt	spot
saptured	captured
onpt	kept
ald	old
footsetps	footsteps
cpme	come
achool	school
childhhod	childhood
foot	fork
bice	bike
if	of
dos	dog
ahere	there
fhotographs	photographs
hom	how
cea	sea
phptograph	photograph
begetation	vegetation
erink	drink
perring	peering
tith	with
takil	taken
cabdes	candes
woaman	wowman
on	of
bommon	common
olants	plants
wov	wow
oainting	painting
tint	tiny
heavb	heavy
groom	broom
eood	food
not	hot
oof	off
takr	take
suckid	sucked
sliny	shiny
hoildays	holidays
ahe	the
jeep	keep
rarachutte	parachutte
crods	cross
kew	new
truing	trying
paople	people
aun	sun
favoutire	favourite
amnounce	announce
danferous	dangerous
worrj	worry
thats	that'
wallway	hallway
od	os
an	in
tn	in
rosee	roses
aill	will
son'	don'
lookd	looks
plat	play
lirials	serials
on	an
mears	bears
amuesu	ammesu
im	in
walching	watching
sn	in
beautifol	beautiful
graxing	grazing
hardwor	hardwpr
mr	my
stss	kiss
weraing	wearing
ouirt	shirt
fifferent	different
mouk	monk
rives	river
pittle	little
mreating	creating
rame	same
go	do
perple's	people's
vass	vase
shairs	chairs
iemi	semi
acintific	scintific
wayes	waves
foccer	soccer
siut	suit
clad	glad
occtpaied	occupaied
gi	go
shgn	sign
can't't	can'n't
swo	two
uonderful	wonderful
reoden	wooden
nalloons	balloons
beuatiful	beautiful
losked	locked
wothe	withe
beige	brige
mhis	this
bery	very
wrecied	wrecked
ne	me
yoe	you
flytng	flying
sitrrng	sitting
grown	brown
instrumwnts	instruments
enjine	engine
sbaks	snaks
bn	in
such	suck
bmazing	amazing
padsing	passing
rrgey	bogey
tor	for
mome	dome
bookshslves	bookshelves
purved	carved
tither	either
ping	pink
rhe	the
whire	white
whar	what
yoday	today
is	in
fiel	feel
we	me
takinf	taking
snall	small
iy	by
coll	cool
rhrough	through
scrinbled	scribbled
proofes	proofed
mt	me
radybuy	ladybuy
blankuet	blanquet
ded	red
beaytyful	beautyful
awas	away
tiles	miles
lrave	leave
rave	race
fron	from
wabt	want
in	on
we	in
goinh	going
ehd	god
flowere	flowers
ht's	it's
glas	glad
biach	beach
finny	funny
practive	practice
sre	are
embroudary	embroidary
copboy	cowboy
is	it
spenm	spend
vocered	covered
mede	made
gress	dress
tow	how
stank	stack
af	of
in	is
cobbestone	coblestone
fround	ground
wirh	with
fell	feek
plaies	planes
demilishing	demolishing
g	i
slone	alone
walkinh	walking
friver	driver
bate	gate
dind	sand
anr	for
thw	the
aere	were
iobot	robot
trabsparent	transparent
pooo	pool
sojething	something
in	on
gitl	girl
uou	you
tith	with
wying	lying
toady	today
attemps	attempt
snigfing	sniffing
enjoyung	enjoying
walkinn	walking
antigue	antique
thingh	things
h	i
gittle	little
amlost	almost
yhree	three
clue	blue
asf	ash
begind	behind
sas	has
weeding	wedding
luuh	luch
hoe	see
buautiful	beautiful
beliece	believe
lonrly	lonely
in	is
confuded	confused
est	eat
ahe	the
faild	field
doet	dont
evem	even
marches	matches
wts	its
peft	best
dat	day
bedind	behind
mhroughme	throughme
it	at
bice	bike
ladied	ladies
brid	bird
toya	toys
carruing	carrying
akso	also
n	a
bubblrs	bubbles
in	on
awo	two
balck	black
r	a
wotld	world
desplaye	displaye
yhe	the
mote	more
coloue	colour
fooftop	rooftop
uniformsd	uniformed
everebody	everybody
hat	hrd
per	gir
lo	so
leautiful	beautiful
shair	chair
amttle	little
jumpang	jumping
bidycles	bicycles
tjis	this
vlose	close
dpn'	don'
steading	steaming
rosd	road
slow	snow
aou	you
microsvope	microscope
uo	up
reke	take
larer	layer
chds	kids
copours	colours
sniif	sniff
o	d
band	bank
hw	he
ahile	while
pas	pad
srdfing	sudfing
otand	stand
cood	cold
yo	do
nad	and
af	of
canl	call
cobered	covered
noe	now
dinnr	diner
ut	it
umbreala	umbrella
merves	nerves
big	beg
snly	only
bigboos	bigboss
atanding	standing
grad	grod
ectremely	extremely
nery	very
menes	males
weeding	wedding
rode	ride
tf	of
chacking	checking
sell	cell
vream	cream
pricacy	privacy
io	in
traim	train
wases	waves
an	on
parled	parked
hry	hey
vooks	books
benind	behind
ptones	stones
wow	how
h	i
tou	you
instryment	instrument
poease	please
petsls	petals
civid	vivid
tortoons	cortoons
knew	know
thata	thats
jutterfly	butterfly
fo	to
wwere	where
bodu	body
daya	days
gone	done
cose	rise
plating	playing
ind	and
buciness	business
wan	can
brigk	brick
airty	dirty
geme	game
my	by
soung	young
our	out
mam	man
sisplaye	displaye
om	oh
amall	small
plauing	playing
bitds	birds
thich	thick
tires	tired
sandwithed	sandwiched
ana	and
amoochign	smoochign
be	ye
anow	snow
heae	here
increduvle	incredible
ghe	the
socipy	stripy
li	am
surroinded	surrounded
devel	devil
teo	two
composicion	composition
blie	blue
iw	it
flokw	floke
chsir	chair
shocjed	shocked
shood	shoed
yndera	undera
wotg	with
af	of
construstion	construction
weading	reading
blie	blue
flaces	places
buiterfly	butterfly
ompoetition	competition
iten	when
dady	lady
cing	sing
raod	road
hissing	kissing
isod	food
gake	make
soccor	soccer
protrucing	protruding
aire	fire
colir	color
perng	being
handing	hanging
bwautyful	beautyful
ful	fut
enjoyimg	enjoying
hew	new
swawberry	stawberry
looke	looks
sitiin	sittin
o	a
aut	out
in	on
firh	wirh
ruuning	running
tapturing	capturing
mant	many
sone	some
camers	camera
looling	looking
soembody	somebody
bountain	mountain
prctured	pictured
liktle	little
ahe	the
larde	large
ps	is
coutume	costume
iear	near
loman	woman
s	a
thatkgod	thankgod
wou	you
mt	my
sitteng	sitting
ay	by
iehind	behind
watchung	watching
og	of
aot	lot
bvckground	background
dhe	the
sprcies	species
peing	being
avove	above
time	tide
tlying	flying
shodows	shadows
poses	poles
birs	bird
vecause	because
sle	are
th	on
tirl	girl
th	my
sming	swing
pushia	fushia
croun	crown
brae	tree
sity	city
sace	race
reakize	realize
ant	any
dummi	dummy
whared	scared
le	me
ahat	what
photogracher	photographer
sondolence	condolence
bobody	nobody
insuranve	insurance
ar	at
blalk	black
cols	cold
mear	near
harge	large
neqr	near
soeing	sowing
readu	ready
hield	field
visitie	visible
arom	from
sku	sky
mary	very
ans	and
cound	could
cibrant	vibrant
thes	this
readu	ready
onto	into
firl	girl
frezzing	freezing
sogs	dogs
ipjone	iphone
in	on
should'nt	shouldn't
ay	at
blie	blue
w	a
everythine	everything
mt	my
jooks	looks
darnkess	darkness
vell	well
waitang	waiting
compatton	compation
cleberating	celebrating
yall	tall
cuocake	cupcake
oea	sea
perple	people
ablut	about
r	'
situaaed	situated
od	of
piking	making
msny	many
liik	look
there	these
custimers	customers
thar	that
s	a
yhe	the
tith	with
exercese	exercise
parled	parked
fot	fog
mororized	motorized
garred	barred
folorful	colorful
nitht	night
backetball	basketball
bear	near
coolection	collection
alt	art
bust	busy
whre	were
fot	for
agaonst	against
soorway	doorway
aeroplant	aeroplane
on	in
ghat	that
arount	around
se	be
bece	nice
rlue	blue
kalk	walk
inod	wood
loep	keep
otopping	stopping
rhrough	through
c'	i'
fhotos	photos
brsertive	assertive
silhoestte	silhouette
mise	vase
t'm	i'm
tis	his
sarked	parked
tae	the
fo	to
vuildings	buildings
bea	sea
sprcs	specs
incide	inside
loolipop	lollipop
sly	sky
happi	happy
that	than
breach	brunch
vecause	because
mly	fly
ihe	the
aith	with
insdie	inside
behing	behind
rower	tower
w	i
gave	have
ti	to
cept	kept
rid	red
big	beg
hegs	legs
iren't	aren't
fruite	fruits
tho	two
clice	slice
burger	larger
os	is
place	plays
gmae	game
wodern	modern
resemblrs	resembles
kike	like
groop	group
pottle	bottle
blacket	blanket
bu	by
cehicle	vehicle
gurl	girl
sailboars	sailboats
tha	the
mave	have
rere	rare
ccn't	can't
photographr	photograper
stamding	standing
twi	two
dlosed	closed
syy's	say's
pwople	people
pench	bench
lighshouse	lighthouse
citting	sitting
grabny	granny
siskinghis	riskinghis
in	is
somr	some
toaghrt	togahrt
hars	hard
enlking	walking
vert	very
a'	i'
ahe	the
out	put
baol	baot
gatup	getup
de	we
dusks	ducks
chaur	chair
dtreet	street
mist	most
gtraslucent	translucent
firn	corn
mounain	moutain
tront	front
wirher	wither
class	glass
finihed	finised
on	in
goung	young
shod	show
meeth	teeth
bateball	baseball
woom	room
onto	into
make	made
hunger	hunter
aog	dog
durrounded	surrounded
wvery	every
slaying	playing
blavk	black
btanch	branch
cm	am
sup	cup
meings	beings
abstract	obstract
tog	dog
wors	word
gig	big
fiald	field
blacj	black
sadge	large
suilding	building
colordul	colorful
fight	right
in	on
diffinult	difficult
aparement	apartment
af	if
fn	in
wilh	with
ab	an
wee	see
bankl	banks
trom	from
comforrably	comfortably
toi	two
good	wood
abondoned	abandoned
cays	toys
ti	to
biew	view
is	if
hemebody	somebody
todat	today
an	in
at	it
onether	another
oy	by
fowns	fawns
snace	dnace
cool	call
abobe	above
eater	water
an	in
twll	tell
unter	under
undustrial	industrial
man	men
gind	land
rirfomrs	perfomrs
at	on
sin	sun
an	at
firlds	fields
rol	row
elderry	elderly
pplice	police
io	do
mhe	the
umprella	umbrella
beautoful	beautiful
ghe	the
g	n
tod	now
ahere	there
bitterfly	butterfly
ciring	crying
talling	talking
hids	kids
tmoatos	tomatos
siiting	sitting
srawn	drawn
o	a
hoy	joy
mulips	tulips
differnn	differnt
ypu	you
prty	prey
whe	the
winnwr	winner
titting	sitting
laft	left
likhts	lights
ve	we
merson	person
opt	out
it	at
mh	oh
in	on
alass	glass
on	in
chicdred	childred
leabe	leave
dea	sea
thet	they
kings	kinds
ao	do
freen	green
i''l	i'll
v	a
frown	brown
cip	sip
in	on
od	of
barge	large
e	i
dost	lost
on	in
dedicately	delicately
gog	dog
al	am
nenc	benc
birs	bird
ill	all
case	cast
elerything	everything
reclection	reflection
i	a
ehe	the
silled	filled
ilace	place
umbrella	umbralla
persond	persons
travekling	travelling
signxits	bigexits
naking	making
ferrir	ferris
lin	can
uellow	yellow
wutfit	outfit
vefore	before
a	i
sept	kept
pirson	person
vlocked	blocked
floars	floats
mafe	made
altually	actually
wesn'	wasn'
whaelbarrow	wheelbarrow
chait	chair
opoosite	opposite
sensitice	sensitive
raining	raiding
playe	plate
bathr	bathe
flanes	planes
wikl	will
bif	big
likstick	lipstick
modt	most
o	u
can'y	can't
ared	area
pf	of
wand	want
an	on
wases	waves
rases	roses
calking	walking
hy	my
pwrmission	permission
iustrument	instrument
her	hur
myke	like
horriage	carriage
beautifyl	beautiful
polot	pilot
dor	for
wood	food
wwaling	walking
sunnd	sunny
haking	taking
docotrs	doctors
tge	the
mye	the
cidewalk	sidewalk
in	on
enjoping	enjoying
trenty	twenty
pmall	small
huitar	guitar
sly	sky
st	is
dovk	dock
frint	front
uhis	this
eetting	setting
heanen	heaven
wey	hey
frt	out
mor	for
walm	walk
thich	thick
sown	down
aut	but
eoin	join
vicrant	vibrant
tottaly	totally
saining	sailing
rinning	running
build	built
realyty	reality
i	t
bhe	the
takrying	carrying
blscj	blacj
ptetty	pretty
weach	beach
af	of
rad	red
comr	come
tho	two
books	boots
figurenes	figurines
buge	huge
bugular	regular
stick	stuck
l	i
galf	half
parachutrs	parachutes
non't	don't
pamoflague	camoflague
attaching	attacking
tut	but
situared	situated
thrir	their
t	i
gr	so
yo	to
fuil	full
sailming	swimming
hey	let
alse	else
smpile	simple
antire	entire
dits	sits
alags	flags
his	him
hie	his
s	a
graffici	graffiti
btanding	standing
fp	of
goung	going
drawb	drawn
wheee	wheel
sjeet	sheet
ih	in
scis	this
eprsons	persons
lpt	lot
thside	inside
lvave	leave
ice	icy
five	give
everithing	everything
ps	is
fapp	fall
nodboy	nobody
klways	always
ait	hit
broige	bridge
teady	ready
fater	water
brfore	before
bycycle	bicycle
brighe	brigde
airplaie	airplane
behimd	behind
hots	lets
happiest	happyest
siats	seats
dilapitated	dilapidated
surfice	surface
bycycle	bicycle
fron	from
iold	cold
mr	me
pinecose	pinecone
jsmen	women
thrst	first
sllep	sleep
tn	on
nite	late
froup	group
hugd	huge
importata	important
wyu	why
ag	as
chiiken	chicken
crosd	crowd
hikks	lokks
sor	for
butterfiy	butterfly
spoots	spoons
mormal	normal
peoole	people
big	bug
airplace	airplane
huildings	buildings
an	on
wach	each
amn	ain
engoying	enjoying
chape	shape
soomethinf	soomething
goos	good
heir	hair
sdie	side
tike	like
abour	about
thinf	thing
l	i
ssde	side
cnack	snack
fr	at
w	a
combimation	combination
wany	want
anf	and
ia	in
gat	cat
vovered	covered
oeople	people
har	hat
tined	lined
on	in
kong	long
practinin	practicin
gibe	give
coeling	feeling
fighy	fight
foothall	football
or	of
veru	very
ceason	reason
ne	be
gove	give
fridnds	friends
soccor	soccer
peopers	peppers
iy	by
dlante	plante
on	to
leave	leafs
veauty	beauty
painfil	painful
its	it'
coats	goats
algo	also
dirs	dirt
ohter	other
wlying	flying
beaufiful	beautiful
scenere	scenery
cab	can
weering	wearing
onarts	starts
wach	each
b	a
ducking	sucking
retriewer	retriever
splendis	splendid
girafee	giraffe
bodt	boat
buring	during
bwat	boat
nt	in
stomngest	strongest
fresses	dresses
o	i
eithout	without
tird	tied
swawberry	stawberry
snappyng	snapping
for	fog
tappened	happened
ficond	second
wight	right
misdle	middle
dolphon	dolphin
moding	moving
hsd	had
sdenic	scenic
ane	one
ty	my
shg	big
eith	with
hig	big
dou	you
hace	have
gerl	girl
inluminated	illuminated
fomous	famous
orom	from
weirdesr	weirdest
blawer	flower
minf	mind
ot	at
of	or
peach	beach
cammls	camels
linely	lonely
songing	singing
sowards	towards
te	me
sailway	railway
cant	can'
yhis	this
shows	shoes
aolding	holding
buioding	building
marchinf	marching
stahe	stage
mu	my
behond	beyond
weather	whether
in	on
handed	hanged
gane	game
platform	plotform
t	y
ypu	you
eal	eat
chite	white
puch	push
amaricain	americain
ti	hi
scenery	scenary
phtoograph	photograph
sive	live
sungalsses	sunglasses
site	side
dont	don'
beaitifully	beautifully
saking	taking
jumped	humped
virds	birds
havit	habit
ditting	sitting
d	i
flont	front
dint	dont
might	right
brach	beach
meautiful	beautiful
telophone	telephone
id	is
pepers	papers
bichcles	bicycles
c	a
wiw	wow
these	there
pn	on
gluare	square
puildings	buildings
gnily	onily
protform	platform
tigh	high
sece	face
koney	honey
foaves	leaves
inaring	wearing
coccer	soccer
uou	you
arpear	appear
neol	cool
good	food
bloudyk	cloudyk
is	in
hooror	horror
axtreme	extreme
ahema	thema
ied	red
dowm	down
wifel	eifel
sower	tower
stanking	standing
tomplete	complete
ou	on
ahy	why
eas	eat
sellong	selling
donsn't	doesn't
hatching	catching
eag	egg
clsoing	closing
woek	work
sibmersion	submersion
dirferent	different
calentine'	valentine'
futurestic	futuristic
firegrucks	firetrucks
solhouette	silhouette
behinf	behind
croos	cross
sining	siting
throwgh	through
wauting	waiting
tatching	catching
kade	made
yhe	the
olone	alone
vith	with
cicirate	cigarate
bept	kept
uou	you
throen	thrown
finoshing	finishing
riging	riding
lit	sit
l	i
oerson	person
phoson	person
wround	around
hwere	where
bfight	bright
aonnected	connected
couourful	colourful
gombing	jumbing
tiv	tie
earing	eating
btight	bright
horsr	housr
soie	some
het	her
asd	and
aolding	holding
asim	anim
musicions	musicians
eee	see
stonw	stone
fed	red
ne	me
blacc	black
wavws	waves
fregnance	fragnance
wveryone	everyone
ruew	rulw
ghrough	through
ot	of
halking	walking
bnap	snap
punk	pink
mow	few
sittiog	sitting
girts	girls
prgeons	pigeons
eater	water
fow	fox
standiug	standing
as	is
belings	belongs
tashy	tasty
throygh	through
thkink	thiink
riging	riding
bug	big
ihis	this
ilso	also
ans	and
fhooting	shooting
cinfused	confused
ht	it
in	on
wurrounded	surrounded
footo	photo
tilk	milk
lach	lack
get	not
replect	reflect
snd	and
founf	found
buuterfly	butterfly
bee	bed
spreding	sprading
toady	today
fet	get
mo	to
un	in
woth	with
welonmong	welcimong
ownwr	owner
basses	passes
id	is
unitue	unique
hwy	hey
kike	like
girk	girl
t	a
labtap	labtop
is	in
cgicken	chicken
od	of
cal	can
boock	black
cerson	person
som	son
mace	race
wook	book
neen	been
prople	people
tre	are
aftermoon	afternoon
atikes	stikes
c	a
gan	can
iucks	sucks
stongs	stonds
booloon	balloon
ther	they
hit	his
fashtr	father
uou	you
worls	world
alonr	alone
thkes	takes
looving	looking
worst	worse
stonehende	stonehenge
plings	things
alack	black
housee	houses
peor	peir
ay	by
sidside	seaside
waithng	waiting
ind	and
rports	sports
alr	all
beay	very
hangind	hanging
wor	won
chrck	check
w	a
an	at
houde	house
antigue	antique
exvercises	excercises
inder	under
driobng	driving
bolice	police
torough	through
ane	one
traid	train
sle	ski
al	in
thorwing	throwing
trea	tree
yo	no
cigarette	cigaratte
ruuning	running
donibo's	donino's
rhe	the
wiver	river
beney	honey
cwrtion	certion
ahe	the
necome	become
dtudies	studies
girlffe	giraffe
collrful	colorful
shoes	shows
aith	with
glower	flower
wgere	where
in	on
encvcrage	encourage
goad	road
boars	boats
suckung	sucking
have	hope
origani	origami
snowfalkes	snowflakes
buots	boots
wirh	with
coeen	green
ihis	this
ther	this
americal	american
shoet	sheet
veir	veiw
stufk	stuck
ms	us
veach	beach
upen	open
unbrella	umbrella
hiil	hill
ahe	the
mee	see
dan'	can'
peouds	clouds
strsnge	strange
singals	signals
ina	tha
in	is
ome	one
ext	but
moman	woman
hidh	high
ot	it
autside	outside
anf	and
bl	it
whilr	while
kwimming	swimming
bire	fire
statur	statue
ascause	because
gicl	girl
tho	two
oan	man
csk	ask
aourist	tourist
eith	with
beek	beak
mn	in
wn	an
worng	wrong
rave	have
neside	beside
fairis	ferris
aib'	ain'
lree	tree
gor	for
slaying	playing
lile	like
enjou	enjoy
on	an
fron	from
is	on
meople	people
danderous	dangerous
droup	group
flipdlops	flipflops
hive	give
runnyng	running
christnas	christmas
glads	glass
gogs	dogs
thet	they
backet	jacket
draginfly	dragonfly
a	i
picnik	picnic
a	i
pody	body
everywhers	everywhere
celenration	celebration
plesae	please
decordted	decorated
lbst	obst
wicke	licke
dringing	drinking
bis	big
windiw	window
uour	your
slopping	slepping
yhe	the
bead	bear
tyoes	types
fellow	yellow
mondey	monkey
momemt	moment
merchandish	merchandise
fiels	field
tto	too
doen	down
upbrella	umbrella
aeople	people
ilying	flying
part	park
bysy	busy
eas	eat
brisge	bridge
photograpg	photograph
demicircular	semicircular
part	park
wooks	looks
asasd	asked
mital	metal
og	of
is	it
uuder	under
cylces	cycles
myw	how
chatr	chair
hye	bye
differeet	different
fas	gas
ciolin	violin
cases	casts
bunana	banana
bw	be
accing	acting
me	my
frorescent	florescent
irives	drives
waler	water
thw	the
judhe	judge
ahotographs	photographs
ypu	you
thes	this
don's	don't
surace	suface
visalbe	visable
polular	popular
deriouslt	seriouslt
alack	black
gtand	grand
ola	old
iust	just
whe	the
pf	of
tees	bees
illumunated	illuminated
dhildren	children
sorsa	torsa
cudtomer	customer
atmosfire	atmospire
slelter	shelter
stafe	stage
aooking	looking
greenery	greenary
tracj	track
prople	people
temble	temple
feflects	reflects
tje	the
mthers	others
ract	yact
breakdast	breakfast
gkass	glass
pile	pale
ikating	skating
roo	red
pease	peace
tut	out
ouer	over
pole	pile
if	of
handing	hanging
wauting	waiting
slso	also
thise	these
whay	what
lans	land
beener	better
ahe	the
ie	me
sods	kids
dole	able
storrgew	storagew
us	is
nt	it
noe	now
hancicap	handicap
piease	please
loe	the
reflrction	reflection
uou	you
meador	meadow
wat	was
folding	jolding
raining	railing
sistrub	distrub
wlaking	walking
instructer	instructor
paralles	parallel
sence	sense
mater	water
f	i
dinino	dimino
blacj	black
od	of
iuite	quite
y	i
thnak	thank
tries	trees
mn	in
lines	lined
biew	view
lika	like
couldy	cloudy
jome	come
i's	i'm
down	town
comething	something
ealks	walks
boll	ball
in	on
sgows	shows
there	where
beautifyl	beautiful
make	take
shawow	shadow
ponk	pink
melom	melon
thot	that
smiking	smiling
sige	side
unto	into
in	is
atfore	before
upsat	upset
drip	drop
reflavted	reflected
strawberried	strawberries
favoutite	favourite
theough	through
peiples	peoples
theu	they
ead	eat
d	a
yoy	you
filed	field
freat	great
fidficult	difficult
numbesrs	numbeers
taease	please
w	i
paing	paint
are	aof
mu	my
dedding	wedding
piece	peace
steepse	steeple
ior	for
tou	you
ewars	wears
thr	the
bomantic	romantic
bord	lord
sranslucent	translucent
fhrough	through
cpvered	covered
explontin	explotion
palying	playing
raght	right
tilip	tulip
woung	young
pocked	docked
unbrella	umbrella
lovenle	lovanle
btone	stone
leavs	leafs
w	i
ic	is
burt	burn
hace	have
lenon	lemon
ca	is
iseeling	kneeling
uou	you
girafee	giraffe
animans	animals
grrom	groom
senging	singing
os	is
fo	go
nouples	couples
flowting	floating
todau	today
its	it'
san	sad
ta	to
sites	bites
desturb	disturb
lite	like
cattin	sittin
hi	of
solioary	solitary
playinf	playing
asaint	againt
women	woman
vegetrble	vegetable
frunt	front
kiked	liked
as	at
sbowy	snowy
hree	here
trialhalon	triathalon
vwry	very
cs	is
muy	guy
yourg	young
don'	can'
sust	just
quility	quality
iere	here
wiyh	with
oith	with
passengere	passengers
id	me
alearly	clearly
mobule	mobile
raceng	racing
xanal	canal
if	of
elevtric	electric
rounf	round
id	is
lokkinhg	lookinhg
shooo	shoot
mecca	macca
hufe	huge
bvack	black
gimnastic	gymnastic
thiy	they
sleee	sleep
evry	ever
af	as
ourple	purple
anybodu	anybody
galf	half
hoss	boss
somw	some
teo	two
abong	along
tha	the
s	a
shoting	showing
falm	calm
wizord	wizard
enlorged	enlarged
e	'
at	as
electricyty	electricity
churth	church
duite	white
skiet	skirt
teaning	leaning
waight	weight
nexr	next
loa	lot
fiv	six
mee	see
gelow	below
railroac	railroad
ofer	over
tn	in
thus	this
subrerged	submerged
hlue	blue
ret	not
waking	waling
inder	under
rapidky	rapidly
fla	fly
valloons	balloons
thang	thing
bookd	books
shore'	store'
hundrads	hundreds
beaytiful	beautiful
hngry	angry
ghineese	chineese
frw	few
goth	with
beacj	beach
eith	with
mrom	from
siitgng	sitting
croud	crowd
on	in
d	a
melieve	believe
pwimming	swimming
yhis	this
brifge	bridge
hver	ever
coims	swims
tpday	today
wabe	wave
t	a
ind	and
cant	can'
affaid	afraid
os	is
besch	beach
boot	foot
walming	walking
honcert	concert
therry	cherry
canpt	can't
grum	drum
h	a
buggles	bubbles
viviting	visiting
m	a
mitch	match
snowly	snowey
thet	that
armchsir	armchair
yhis	this
locket	rocket
suys	guys
jumbing	jumping
tro	two
wrick	brick
hench	bench
sricks	tricks
haoo	sooo
gatw	gate
as	is
xandles	candles
loming	coming
alaying	playing
thie	this
in	on
pimpkins	pumpkins
ang	and
throwsd	throwed
tn	an
eovers	hovers
ropples	ripples
pl	is
cery	very
tack	back
eath	each
thual	usual
friendz	friends
while	white
wyes	eyes
clere	clear
graffityfilled	graffitifilled
buyinn	buying
ma	me
fireng	firing
wo	to
cour	your
timr	time
m	i
sifferent	different
aeaning	leaning
her	the
iy	my
s	a
cled	sled
chinarow	chinafor
planing	playing
dabcers	dancers
onone	alone
t	a
brautiful	beautiful
widard	wizard
tomororow	tommorrow
heu	hey
oeople	people
homw	home
aiu	oiu
agianst	against
h	a
os	is
knnw	know
beaytifuk	beautifuk
uou	you
vicycling	bicycling
wiw	wow
wivered	covered
wun	win
goind	going
mw	me
on	in
kike	like
eacj	each
sdncing	dancing
vandalised	vandalized
yome	come
somw	some
hioing	hiding
beautigul	beautiful
hoe	how
aother	mother
pratise	pratice
pench	bench
sku	sky
as	is
we	se
m	a
gor	for
ilaced	placed
performang	performing
dont	don'
ball	tall
going	doing
ihe	she
juck	duck
slepping	sleeping
og	of
yoing	young
conatining	containing
gall	fall
tront	front
comw	come
meself	myself
mountyin	mountain
smere	there
clrar	clear
bu	by
t	i
kataj	kayak
whatrver	whatever
vandle	candle
whick	which
fat	eat
droptets	droplets
helllod	hellgod
piercinfs	piercings
netro	metro
it	up
thid	this
moush	mouse
sittimg	sitting
shasow	shadow
neat	near
perfon	person
coverdd	covered
wiyh	with
gravuty	gravity
peiple	people
sxpensive	expensive
heave	heavy
nan	can
xan	can
leys	keys
thete	there
bater	water
browm	brown
wake	fake
umbreala	umbrella
cocus	focus
thefy	theft
bycycle	bicycle
chruch	church
worj	work
siti	sits
peace	piece
plave	place
pedeetrian	pedestrian
begale	beagle
chileren	children
ttings	things
playinf	playing
uou	you
thet	that
sinc	sits
kissung	kissing
phoios	photos
readj	ready
enjoyong	enjoying
raves	waves
perssn	person
sumething	something
safefy	safety
cll	all
iow	how
mur	far
sont	dont
cith	with
had	hat
mature	nature
brege	brige
snjoying	enjoying
hod	god
wo	so
itme	time
incect	insect
sant	want
as	is
hwr	her
wet's	let's
ststue	statue
ia	is
ahe	the
od	of
three	there
full	fall
tn	on
ahere	where
sape	some
railwat	railway
trumper	trumpet
futside	outside
precticing	practicing
hi	an
od	of
elecen	eleven
rever	river
ihe	the
morninh	morning
rxam	exam
blacl	black
gliw	glow
bull	wall
tho	two
conjustee	conjusted
kake	take
swaet	sweet
wriring	writing
hi	on
dackdrop	backdrop
blobes	globes
ire	are
symbil	symbol
os	us
hoe	how
rath	lath
ane	are
bouth	mouth
dropsets	droplets
om	on
grouo	group
mly	fly
behinf	behind
cplord	colord
imen	even
creater	creator
walting	walking
verr	very
srom	from
awak	away
lught	light
fill	full
loe	are
reflectige	reflective
pumpin	pumkin
poeple	people
t	i
migdle	middle
sn	in
vall	ball
bottles	bottle'
me	my
yts	its
bear	near
sfae	safe
stonghenge	stonehenge
verr	very
gwound	ground
lorest	arrest
lighyning	lightning
bytthey	butthey
if	of
persong	persons
oachother	eachother
in	on
gitting	getting
puppkin	pumpkin
gitl	girl
oeremony	ceremony
fiw	few
oid	old
atring	during
ner	new
aoon	soon
beautifyl	beautiful
mye	the
alin	alon
replection	reflection
roman	woman
wjole	whole
his	its
wetween	between
exceelent	excellent
wm	am
anjoying	enjoying
kady	lady
morfect	perfect
enhoying	enjoying
reom	room
chich	which
thier	their
workd	world
srees	trees
boall	small
frass	grass
ateempt	attempt
tn	on
on	in
hardlr	hardly
aen	men
strert	street
toe	the
handinf	hanginf
firl	girl
thr	the
ple	are
un	in
plase	place
flmaes	flames
airplaie	airplane
am	in
dnjoying	enjoying
mointains	mountains
gackroung	backroung
strret	street
stwer	power
do	to
crawes	crawls
wearn	wears
dgound	ground
o	a
bn	in
shuitle	shuttle
daying	saying
wow	how
wkman	woman
thes	this
foregrougd	foreground
distarvtion	distarction
on	of
vey	cry
ther	they
pf	of
gost	just
mer	for
ladfder	laddder
wasing	wading
wwman's	woman's
waqer	water
bootom	bottom
me	be
workd	world
an	'n
iwo	two
praticeng	praticing
homily	family
she	the
stall	small
indide	inside
yottle	little
ohotos	photos
rines	lines
an	am
ornage	orange
m	i
flyes	flies
lokking	looking
thke	take
ear	eat
can'y	can't
nace	nice
yping	young
nery	very
ihis	this
plaies	planes
resy	reay
tat	eat
lence	lense
loce	love
gallons	ballons
strret	street
beautilul	beautiful
locatid	located
siiting	sitting
wnjoying	enjoying
knve	have
beatballs	meatballs
theough	through
gaven	given
brifhtly	brightly
thme	some
iea	yea
habd	hand
whick	which
yn	an
norrow	narrow
wtanding	standing
onderwater	underwater
an	in
laing	being
handing	hanging
beaytyful	beautyful
youe	your
anm	and
ohrough	through
ceramer	creamer
ie	we
luals	meals
pick	pink
pioto	photo
p	a
cho	who
yelloq	yellow
ppums	plums
drinning	spinning
p	i
flowere	flowers
ahe	the
surger	surfer
ip	up
aot	not
stiil	still
inu	you
whp	who
heve	have
citw	view
stram	strem
wa	on
anly	only
a	i
whth	with
rents	tents
womam	woman
lall	tall
rodad	rooad
sog	dog
atanding	standing
lughthouse	lighthouse
birl	girl
uens	mens
is	in
bed	red
feflecte	reflecte
listenyng	listening
s	i
latge	large
pror	poor
wao	who
woamn	woman
woeld	world
mize	size
tupips	tulips
skty's	city's
focussng	focusing
flipe	flips
thrle	while
th	to
colofulf	colorful
hundruds	hundreds
netrance	entrance
do	go
angey	angry
giall	small
pkaced	placed
ans	and
onlr	only
h	i
cheery	cherry
outsr	outer
ti	to
dadly	badly
eaual	equal
treed	trees
acean	ocean
oj	oh
yeaj	yeah
watxh	watch
nushroom	mushroom
figurene	figurine
urnan	urban
cighed	lighed
fird	bird
prople	people
taving	giving
fatable	eatable
wx	ox
ellergcx	ellergix
pph	ooh
collest	coolest
righa	right
rfforts	efforts
likht	light
featival	festival
ou	go
solourful	colourful
hot	got
stiil	still
noe	now
smale	smile
vaby	baby
tdon't	idon't
drees	dress
froend's	friend's
fress	dress
disturd	disturb
doesnt	doesn'
mosse	moose
vars	bars
th	my
swiming	swimmig
dramw	drama
on	in
holyday	holiday
friemds	friends
ony	any
iany	many
hime	home
noonles	noodles
nootball	football
flad	flag
traes	trees
cights	lights
tading	taking
ldmire	admire
paino	piano
toucgj	touchj
gliat	float
ft's	it's
yied	tied
s	a
ine	one
wigh	with
fise	rise
comm	come
joim	join
emages	images
bn	in
sly	sky
heaf	leaf
actuallu	actually
raxe	race
inong	among
nam	man
leeh	lesh
ihe	the
dor	for
thr	the
th	to
kit	lot
women	woman
witrin	wearin
hige	huge
theur	their
im	am
nat	not
mmon	moon
din'	don'
ihere	where
sitt	sits
ped	red
ce	we
ftom	from
pif	pig
msall	small
gloating	floating
yhe	the
smimming	swimming
pthe	path
toman	woman
sdared	scared
mest	must
clue	blue
hotses	horses
hnd	and
firning	burning
jewlelert	jewlelery
thrse	these
lyonh	lyinh
gymiastic	gymnastic
kust	just
begind	behind
cycke	cycle
tellow	yellow
warious	various
flyinm	flying
duke	dude
tnto	into
cure	cute
maokies	cookies
chang	chain
hy	my
mant	want
sp	so
if	of
librart	library
fith	with
shich	which
falsh	flash
seel	feel
towching	touching
thst	just
orgnge	orange
cobered	covered
ahat	that
liok	look
haning	having
hare	here
viewwrs	viewers
smiming	swiming
tale	take
seem	seen
biying	trying
ramembers	remembers
loog	look
brny	tiny
dood	good
recearch	research
netal	metal
af	of
pewple	people
blooning	blooming
grownd	ground
serios	series
in	on
well	call
locus	focus
filest	forest
hlay	play
sycle	cycle
ans	and
crass	grass
n	i
wosh	wish
gorizon	horizon
aust	just
veautyful	beautyful
l	t
log	lot
graan	green
wery	very
jandra	sandra
dusturp	disturp
anuthing	anything
fkowers	flowers
bac	bag
drawm	drawn
prtraits	potraits
tje	the
sity	city
gilled	filled
shn	sun
senions	seniors
og	of
yoy	you
heavu	heavy
nhis	this
t	a
poground	inground
aith	with
bowe	bowl
mear	fear
conton	cotton
lting	lying
swimgng	swiming
torough	through
ypung	young
eomplete	complete
slote	close
fress	fresh
t	a
its	it'
bulterfly	butterfly
daeling	darling
dlack	black
whwre	where
waint	paint
saiting	waiting
shhre	shore
purble	purple
sown	down
beaytiful	beautiful
nut	hut
emphzsizes	emphasizes
soundavle	soundable
graen	green
m	i
airplenes	airplanes
wilh	with
ihi	thi
roud	road
aboue	above
larest	forest
dake	take
temembering	remembering
bvue	blue
phobe	phone
ahe	the
butterply	butterfly
wt'	it'
builcing	building
pid	pig
reding	riding
vacuumc	vacuums
m	a
mothet	mother
mater	water
sigh	sign
kat	cat
bolourful	colourful
snoqball	snowball
wnimal	animal
hitt	hill
disty	dusty
behing	behind
bood	good
alack	black
kere	here
infrint	infront
lranch	branch
noe	now
ilue	blue
sets	sits
pucture	picture
printed	painted
aop	top
nexk	neck
sidewilk	sidewalk
uoured	poured
dreps	drops
beaitiful	beautiful
log	big
on	in
aboce	above
were	wore
are	art
our	out
tis	his
whiel	wheel
opeosite	opposite
graas	grass
tip	top
demostratuon	demostration
soot	foot
smekks	smells
perple	people
gneine	engine
prour	proud
momen	women
south	mouth
chaing	chains
sllep	sleep
winds	wings
gingli	gingle
laread	spread
bords	birds
handing	hanging
adtending	attending
hase	have
wlack	black
cofree	coffee
coloyred	coloured
lelp	help
aor	for
hetting	setting
clatinet	clarinet
ban	can
mats	lots
prouping	grouping
displaued	displayed
t	'
fott	foot
kepboard	keyboard
stirage	storage
grey	gray
ballin	ballon
oeating	seating
wery	very
leavc	leave
umprella	umbrella
hom	him
terrosists	terrorists
croud	crowd
horsebadk	horseback
caere	where
dodsn'	doesn'
bick	pick
pope	rope
eve	ewe
frass	grass
quich	stich
rouiding	rounding
iwims	swims
sool	cool
is	it
clear	clean
necause	because
lhe	the
beajtiful	beautiful
bakl	ball
unbrella	umbrella
meerkets	meerkats
whay	what
sly	sky
wonan	woman
guirat	guitat
blice	slice
looked	locked
muy	guy
hil	his
of	on
mjch	much
higlway	hallway
wgut	whit
vovered	covered
destrot	destroy
sunnd	sunny
heir	hair
wvery	every
lipiness	hapiness
tur	our
hoenice	hownice
obscuding	obscuring
kike	like
coberd	coverd
moating	boating
holdeng	holding
kook	look
yoyr	your
whwre	where
all	any
epst	most
prn	man
sity	city
shote	shore
m	a
nend	need
wellieston	wellington
meis	this
goung	young
musd	must
ltraight	straight
nengre	hengre
bair	pair
dn	on
plsase	please
sid	and
buuterfly	butterfly
wjeels	wheels
areat	great
wedies	ladies
ahe	the
skeletan	skeleton
socky	rocky
racks	rocks
sifferent	different
aeople	people
savefron	savefrom
tis	his
hn	in
bettar	better
blaying	playing
gissing	kissing
ftanding	standing
ip	up
neaon	neoin
dovered	covered
wnow	snow
reillies	chillies
paralled	parallel
ar	at
sse'	she'
thws	this
awat	away
gtaring	staring
shis	this
yogs	yoga
uou	you
somrbody	somebody
yne	one
toen	doen
sree	free
thet	that
havong	having
pivie	movie
uou	you
toally	really
places	placed
shouldsrs	shoulders
on	in
uselfss	useless
cee	see
phiw	veiw
officiaathey	officialthey
swam	swan
perserver	preserver
pensils	pencils
fone	gone
looke	looks
inllon	ballon
orance	orange
emply	empty
liiking	looking
tahking	talking
wtih	with
peoper	pepper
everuone	everyone
akong	along
vlue	blue
in	on
caprured	captured
nade	made
platform	plotform
rea	red
barkung	barking
tricicle	tricycle
differtne	different
there	these
insede	inside
ehere	where
beautyfyl	beautyful
postr	posts
seart	heart
elluminate	illuminate
pkants	plants
iothing	nothing
ous	his
ahe	the
shis	this
wvoks	looks
kepting	resting
progemme	progamme
bettwr	better
terrorst	terroist
greee	green
sistanc	distanc
caprured	captured
meke	make
soie	some
suate	skate
wqual	equal
illuminatid	illuminated
in	im
worjing	working
can	car
taje	take
ass	ask
reowing	flowing
buikding	building
tlow	blow
earlt	early
awke	like
lverlooking	overlooking
gree	free
cith	city
man	may
ap	up
sonderful	wonderful
was	wad
esam	exam
wheld	field
thing	think
gatheter	gathered
bosts	boats
pome	some
palce	place
compination	combination
wherw	where
picute	picure
oberbridge	overbridge
l	i
flars	flags
compllte	complete
lonelu	lonely
ihese	these
athers	others
oustide	outside
od	of
thin	than
beautifil	beautiful
wight	fight
afe	are
thw	the
aut	out
beal	real
flaciers	glaciers
beaxh	beach
ase	are
sloe	slow
wat	way
tnthis	inthis
vy	by
longon	london
nor	not
men	man
feeris	ferris
ms	is
rhe	the
ower	over
in	on
runm	room
sos	ans
hiles	holes
thise	these
lept	kept
yhis	this
oeople	people
hravelling	travelling
caund	round
steamu	steamy
shis	this
snands	stands
dractore	tractore
verl	girl
must	just
msall	small
brogher	brother
embarrssing	embarassing
nest	next
hice	hide
cagle	cable
cmall	small
ies	yes
ihown	shown
deady	ready
ovet	over
she	one
soe	the
goinh	going
ced	red
drter	water
ty	my
tet	let
cactures	pictures
mony	hony
scenery	scenary
ofer	over
wate	what
cjildren	children
lall	tall
celevrity	celebrity
mun	mum
beartiful	beautiful
iye	eye
lwmon	lemon
loin	join
vovered	covered
coxy	cozy
whay	what
ot	of
ti	to
m	a
gravfiti	graffiti
darnsness	darnkness
stnading	standing
tan	can
sirrounded	surrounded
ping	pink
zets	lets
tncient	ancient
suing	using
lating	laying
wot	not
ihirtless	shirtless
ieady	ready
ti	to
pulple	purple
trnifers	conifers
og	of
anm	and
warriurlike	warriorlike
sace	save
sointed	pointed
builingi	building
sights	lights
vehicje	vehicle
stuling	styling
wamen	women
cne	one
od	of
booth	boots
w	i
airlield	airfield
drein	drain
nees	need
wike	woke
mice	nice
thirey	thirty
seafuls	seaguls
frint	front
slepp	sleep
thas	this
changeng	changing
mmek	milk
along	alone
expense	expanse
novody	nobody
cleanud	cleaned
no	do
sut	cut
markrt	market
givt	gift
raided	raised
copour	colour
if	of
gigure	figure
veru	very
foing	going
sestroyed	destroyed
inder	under
slue	blue
out	our
prame	frame
balk	bald
winjows	windows
nlean	clean
wr	we
stsnding	standing
higest	hihest
refresging	refreshing
grees	grass
niddle	middle
wiw	wow
thouthy	thoughy
fuvely	lovely
toen	when
thoto	photo
foundain	fountain
w	i
bitds	birds
if	of
cneter	center
happl	happy
jkxed	mixed
abput	about
iwth	with
wi	we
pove	love
on	in
tere	here
noe	now
log	dog
ahppy	happy
oceam	ocean
literatire	literature
sheel	shell
spoot	spoon
oranfe	orange
beautifyu	beautiful
goman	woman
ihere	there
cyclw	cycle
wha	why
stansing	standing
beautilul	beautiful
prieat	priest
hangeng	hanging
sost	lost
tike	like
cil	col
olone	alone
carouiel	carousel
tn	in
bu	by
sstling	styling
piges	pages
tharing	sharing
cmaers	camers
boad	boat
ls	is
o	i
weeding	wedding
test	rest
foal	goal
tae	fae
empyu	emptu
came	come
suttoned	buttoned
ander	under
broge	brige
mt	my
sress	dress
rode	road
marder	harder
fon't	don't
takk	take
overlooning	overlooking
deidge	bridge
hopding	holding
abopo	about
bu	by
wike	like
an	in
botl	bowl
be	me
birs	bird
witdow	window
pnjoying	enjoying
wre	are
palkway	walkway
cocks	rocks
ome	one
gave	have
swinming	swimming
liik	look
aircrafy	aircraft
slone	alone
cammls	camels
pick	pink
ht's	it's
holfing	holding
aulls	bulls
whith	which
gtreet	street
witring	wearing
lyon	lion
srnnt	sunnt
me	my
ckeck	check
bycycle	bicycle
bycycles	bicycles
ls	is
sttre	stare
thank	think
bight	light
ane	are
delisious	delicious
succedsfully	successfully
lwts	lets
crossijg	crossing
blie	blue
ahe	the
ahere	there
bariety	variety
geautiful	beautiful
gice	give
sns	ans
bootom	bottom
handbac	handbag
gratfit	graffit
brodge	bridge
smowe	smoke
nest	best
aeach	beach
iut	out
bedore	before
proframme	programme
bid	bed
hiss	kiss
wre	are
dabcers's	dancers's
pieas	pleas
deat	dead
inong	along
thos	this
buis	this
stoo	stop
t	a
dicicles	bycicles
aeveral	several
iasily	easily
plsase	please
do	so
tace	tree
rhink	think
fiffrent	diffrent
foing	doing
hav	has
goer	deer
blowers	flowers
bocked	docked
supprate	seperate
fill	fell
iooden	wooden
make	made
seasheel	seashell
climn	climb
mhere	there
ladyes	ladies
vappy	happy
slilboat	sailboat
clous	clods
backgrong	backgrond
a	m
ceople	people
lo	am
escalatoe	escalator
pow	few
site	side
af	of
grrup	group
on	in
aollen	pollen
lhut	shut
lotuc	lotus
iten	item
waithng	waiting
viewung	viewing
thie	this
slaying	playing
sellphone	cellphone
cant	can'
tour	your
withe	white
striaght	straight
tocom	becom
alean	clean
al	at
enloy	enjoy
floom	bloom
kike	like
p	a
hish	fish
floars	floats
surgers	surfers
read	road
reat	that
ahe	the
lighhs	lights
shou	shot
cuttong	cutting
pieions	pigions
ttis	this
cigareete	cigarette
will	full
grwat	great
vearing	bearing
ate	are
witdow	window
whast	wrist
wite	wide
tip	top
id	is
rodes	roses
ere	the
beauti	beauty
diess	dress
ew	re
plaved	placed
can	man
iveryone	everyone
colourfyl	colourful
tgis	this
sit	set
dont	don'
toper	paper
habe	have
phott	photo
thr	the
apmostationof	demostationof
vumbing	jumbing
bme	one
narryw	narrow
pottle	bottle
if	is
places	placed
havinf	having
differnet	different
habe	have
qualify	quality
teenege	teenage
white	while
observinf	observing
day	dad
io	in
walte	write
there	these
soup	soap
lolour	colour
intrance	entrance
tide	ride
pirple	purple
ail	all
bracely	bravely
iy	it
longon	london
luke	like
geautiful	beautiful
rmall	small
sound	round
vridge	bridge
ant	any
mate	mats
iim	iam
sean	seen
antrace	entrace
imoto	photo
iear	near
solidyfied	solidified
srying	trying
pribute	tribute
suitcade	suitcase
sicks	socks
tou	you
scean	ocean
stulled	stuffed
as	is
gice	give
outlide	outside
aolor	color
deliciouc	delicious
manu	menu
ghant	giant
sce	ice
hts	its
dressid	dressed
ghe	the
arrrnge	arrange
fkoor	floor
cisit	visit
swving	diving
sweatl	sweaty
eaving	having
spiderlan	spiderman
mamber	member
cucle	cycle
accompanies	accompanied
woming	coming
ait	sit
night	fight
im	am
coomercials	commercials
iy	my
fro	frm
bype	type
ohoto	photo
liok	look
hoe	how
ballon	baloon
ard	and
lig	lit
theough	through
phots	photo
bieds	birds
lolking	looking
mw	me
pegions	pigions
slanding	standing
tha	the
birdes	birdrs
greed	green
blre	blue
bread	break
of	or
whe	the
eaking	taking
mive	give
smole	smoke
thiught	thought
drining	driving
just	jump
wpman	woman
hardwar	hardwpr
distlays	displays
swining	swiming
pird	bird
gly	fly
homey	honey
totice	notice
baba's	baby's
iomebody	somebody
mmm	hmm
sont	dont
rockt	rocky
weating	wearing
fifferent	different
ahite	white
th	my
bi	bu
m	i
parker	parked
birts	birds
esvape	escape
yoe	you
vecicle	vehicle
furure	future
on	in
lolour	colour
yelloo	yellow
giel	girl
lea	leg
swrets	sweets
peaple	people
mig	big
laby	lady
anainst	against
i's	i'm
thw	the
auch	such
gigured	figured
enke	like
whnt	want
stamding	standing
ahe	the
abile	while
pojama	pijama
fjuffy	fluffy
nurge	large
operaaing	operating
hign	high
comdition	condition
wee	see
hia	his
rin	run
fleeping	sleeping
incets	insets
rxperience	experience
mocrophone	microphone
revelslt	reverslt
photure	picture
hehind	behind
snoe	snow
bandy	sandy
post	port
re	is
oi	on
sundet	sunset
tress	trees
h	i
bore	born
marriae	marrige
firend	friend
couplk	couple
dign	sign
dorr	door
sicks	kicks
mu	my
nountain	mountain
camers	camera
funish	finish
handing	hanging
strret	street
if	of
bu	by
craze	crazc
je	he
istting	sitting
abd	and
hin	hid
aftermoon	afternoon
dountain	fountain
seeak	speak
fairnees	fairness
wre	are
pristinelt	pristinely
an	in
ahame	shame
on	in
caufht	caught
aike	like
ght	the
ot	of
redybuy	ladybuy
creamm	creams
whick	which
backgrop	backdrop
clost	close
behinf	behind
fiels	field
hee	see
di	do
selsct	select
nighj	night
oeopleare	peopleare
ispicts	depicts
id	is
dining	aining
ian	iam
talke	talks
smoje	smoke
lig	lit
goinh	going
cal	cat
swiiming	swimming
keen	keep
began	begin
neture	nature
ballin	ballon
arrown	arrows
tailway	railway
bence	bench
uniter	united
wowam	woman
grass	glass
vefy	very
plated	plates
al	at
foom	room
lead	leaf
dide	wide
ffom	from
live	love
darent	parent
theough	through
sityscape	cityscape
aith	with
vehacle	vehicle
futterflies	butterflies
frieght	freight
trnkerbell	tinkerbell
towadsd	towarsd
co	go
shate	shape
posy	post
es	is
umu	you
typd	tied
fooe	food
birght	bright
hace	have
ewchanging	exchanging
win	won
imerged	imersed
oerson	person
lonley	lonely
machibes	machines
tiaed	tired
poeple	people
hosue	house
warer	water
performong	performing
anf	and
cloudi	cloudt
wy	my
our	out
pey	hey
ad	nd
countried	countries
flagg	flags
ere	are
tha	the
pivtur	pictur
waok	look
stanns	stands
thinnkr	thinner
bifallos	bufallos
bathe	baths
hnother	another
on	in
olease	please
uegent	urgent
taje	take
swemming	swimming
iow	how
mibi	mini
pettls	petals
pooks	books
wayching	watching
rired	tired
blur	blue
simgle	single
plood	blood
ban	man
nad	and
awo	two
saucar	saucer
differenc	different
sea	see
grown	brown
clown	brown
bue	the
dield	field
ca	ct
hundry	hungry
overlookeng	overlooking
tmves	moves
mracticing	practicing
r	t
contracted	contrasted
leav	leaf
t	a
i'kl	i'll
nird	bird
staike	strike
wodden	woooen
ola	old
jennon	lennon
peny	many
kake	take
beying	buying
woukd	would
vsps	caps
wontaining	containing
evectric	electric
buldle	bundle
life	lift
ij	in
lwaves	leaves
writter	written
srist	wrist
sxribbled	scribbled
seef	seed
nww	new
ling	long
anziously	anxiously
corrugated	corrigated
fiuh	fish
eeg	egg
streee	street
bycycle	bicycle
peee	peep
omerging	emerging
coses	roses
counrty	country
hac	has
houde	house
fs	is
handing	hanging
sights	lights
hump	jump
ehinking	thinking
thte	shte
coutiful	beutiful
buildingd	buildings
lolking	looking
sxene	scene
batch	match
concert	concret
oighting	lighting
mu	my
ohotos	photos
rifing	riding
dod	dog
postere	posters
buese	geese
font	dont
sishing	fishing
woall	small
in	at
creatice	creative
ane	are
kake	make
his	hit
beople	people
farden	garden
fave	face
sratue	statue
dextination	destination
im	am
taling	taking
skrple	purple
insert	insect
co	in
metimrs	metimes
druge	drugs
flaying	playing
an	am
l	a
gelp	help
builsings	buildings
ye	at
bre	one
nesk	desk
taling	taking
forewrem	forearem
truned	turned
rigen	riden
okaced	placed
rocjs	rocks
fethink	rethink
picyure	picture
firl	girl
chiily	chilly
sity	city
songue	tongue
rifht	right
ifke	make
oisturbed	disturbed
forst	first
wonan	woman
aome	some
boue	blue
u	i
withour	without
grom	from
worls	world
krpt	kept
sitiin	sittin
aot	not
jave	have
onop	atop
trom	from
thier	their
alross	across
pike	pipe
nade	made
wuth	with
oeople	people
visitord	visitors
reatlemen	gentlemen
englidh	english
onean	ocean
climite	climate
coing	going
f	a
floow	floor
wodden	wooden
bn	in
outsodrs	outdoors
bufferfly	butterfly
product	produce
baoty	babty
wery	very
beauriful	beautiful
