pgoto	photo
is	in
thr	the
heft	left
firlfriend	girlfriend
mills	hills
dreat	great
are	and
it	at
whick	which
fo	to
fittle	little
merrr	merry
disturp	disturb
hake	take
wlack	black
soece	piece
condidence	confidence
heat	hear
ded	bed
es	vs
clod	cold
workd	works
anypne	anyone
itveral	several
pther	other
bree	tree
flas	flag
leopers	leoperd
mw	me
blong	along
pland	plant
buatiful	beatiful
bever	never
acainst	against
ker	car
colored	colores
chun	youn
sidturb	disturb
coathery	feathery
ricer	river
cab	can
kiil	kill
fore	pose
sisturb	disturb
io	to
t	i
sharf	sharp
stara	stare
drees	dress
bycycle	bicycle
make	made
closds	clouds
skite	skate
walds	walks
bvown	brown
acuarium	aquarium
gog	fog
keed	need
fevil	devil
dreesed	dressed
tickup	pickup
dring	drink
id	is
articlws	articles
vee	the
beathes	beatles
loat	loft
unbrella	umbrella
somr	some
t	i
brithter	brighter
polots	pilots
that	than
lookins	looking
mur	our
ij	in
wazing	waving
rhe	she
t	a
thise	these
dre	are
lvce	loce
behing	behind
aeatyfull	beatyfull
kips	lips
bighest	biggest
p	n
goles	holes
awo	two
ffet	feet
smole	smoke
undergorund	underground
tragonfly	dragonfly
explaine	explains
ia	is
mcve	move
tat	eat
getterg	getting
straet	street
anvered	covered
fountain	mountain
ire	are
as	is
will	wall
amed	need
w	i
smail	small
bire	bird
grean	green
w	i
shirk	shirt
cant	want
negatibe	negative
bt's	it's
wioh	with
umberlla	umbrella
sood	wood
aver	over
floves	cloves
marker	market
beaqtiful	beautiful
pusy	busy
iles	fles
tur	our
berched	perched
ie	we
pearing	wearing
ehere	where
iy	my
v	a
h	i
disrurb	disturb
ha	in
varitey	variety
recated	located
gride	bride
make	take
ear	eat
tome	time
subeay	subway
gor	for
in	on
shwoing	showing
i	a
ware	were
wlease	please
abobe	above
gormation	formation
us	is
ihe	she
san	sun
flowere	flowers
destrt	desert
riugh	rough
jecliner	jetliner
od	of
goibg	going
anokes	smokes
elimanates	eliminates
cicycle	bicycle
thingig	thinkig
leafes	leaves
clinbing	climbing
ahe	the
wamed	named
bur	but
uet	get
inso	also
swwet	sweet
flyindinto	flyinginto
goona	gonna
sourkrout	sourkraut
tn	in
whhel	wheel
sho	she
thort	short
kin	kig
cnbin	cabin
thinkgng	thinking
secause	because
axplodes	explodes
evewing	evening
rooth	tooth
noy	not
tha	the
kooking	looking
bhe	the
visinity	vicinity
wash	wish
excise	excuse
beatuiful	beautiful
ahr	thr
eacle	eagle
deen	seen
behing	behind
tn	in
ho	is
creayion	creation
adventurous	adventerous
derert	desert
suip	ship
oaveing	haveing
checs	chess
glag	flag
mi	my
woth	with
firt	dirt
merson	person
mur	our
ocon	icon
w	i
tnto	into
tihis	tthis
firmedy	firmely
womewhere	somewhere
dancine	dancing
thid	this
ar	at
seam	seem
shipp	ships
cound	found
tougue	tongue
shoeing	showing
helocopter	helicopter
mu	my
a	i
to	in
wan	can
nextar	nectar
fo	do
wike	like
plating	playing
picycle	bicycle
chme	some
keee	keep
dools	dolls
hot	how
an	on
by	my
mu	my
dakness	darness
nut	but
milty	misty
peackck	peacock
ob	on
yould	would
thus	this
vaccum	vacuum
worksrs	workers
bight	night
brlieve	believe
evtrence	entrence
n	a
ising	using
to	do
thet	theo
tearn	learn
iutside	outside
fron	from
ieed	need
garnt	gaint
fuiio	fuits
ehen	when
yhy	why
pretenf	pretend
owng	king
gerris	ferris
sith	with
g	a
morror	mirror
good	food
ie	we
brd	old
truing	trying
facre	fakre
shllouht	sillouht
ambreall	umbreall
cace	race
furniterds	furnitures
bubbled	bubbles
completey	completly
amd	and
droup	group
wwman	woman
that	this
deats	seats
bext	next
dod	dog
ill	all
teo	two
thise	these
booloons	balloons
inything	anything
aogey	bogey
tront	front
vomplements	complements
olue	blue
mw	me
sayshines	sunshines
sity	city
enjoyinh	enjoying
hode	hose
ihe	the
latearn	lantarn
bettar	better
jon	job
spap	snap
ahinking	thinking
ofean	ocean
holdiog	holding
s	a
kooking	looking
curring	cutting
though	thrugh
ijto	into
fe	me
aeople	people
is	it
backgroynd	background
cginees	chinees
pld	old
wiy	may
coleection	collection
polsibly	possibly
brnach	branch
enen	when
datk	dark
dace	face
bibrant	vibrant
sady	lady
fallong	falling
camares	cameras
leafe	leafs
migdle	middle
whth	both
sashioned	fashioned
s	a
cheerlears	cheerleads
behinf	behind
itw	its
partu	party
perspn	person
streeh	strech
mucis	music
eale	sale
bycycle	bicycle
rhite	white
dool	doll
eindmills	windmills
oausing	pausing
ferrori	ferrari
whe'e'd	where'd
a	i
booden	wooden
fiels	field
beutu	beuty
yo	to
myey	they
grovery	grocery
rexching	reaching
ththered	tethered
tamatoes	tamato's
thst	most
tifer	tiger
soorts	sports
frass	grass
sill	will
theough	through
than	that
bycycle	bicycle
thr	the
fifferent	different
hed	hea
thing	think
wodden	wooden
sistrought	distrought
blooking	blooming
corbor	harbor
vook	book
tel	red
cone	come
krink	drink
og	of
wear	near
sitiing	sitting
seople	people
in	on
in	on
hlse	else
ohy	why
iilang	islang
wright	weight
stutue	statue
ap	up
going	goin'
lonf	long
freahly	freshly
the	are
hom	him
frainst	against
om	on
gey	hey
coloriul	colorful
vooks	books
paly	play
dan't	can't
ausband	husband
ghis	this
onllokers	onlookers
rpeck	check
padsing	passing
meak	beak
nm	am
ged	red
beg	big
smage	image
mnow	snow
peny	many
ball	tall
aye	are
whe	the
aittle	little
as	is
faceng	facing
wight	right
trapeae	trapeze
fridge	bridge
q	a
ihis	this
standubg	standing
bocause	because
morher	mother
fiels	field
yoingsters	youngsters
posh	push
loke	like
thes	this
ger	ver
plag	flag
ammsing	amusing
anohwing	shohwing
aocks	rocks
feild	field
aeane	plane
tele	take
mur	our
hardora	harbora
bluffy	fluffy
balves	wolves
strang	strong
l	a
taht	that
scenatio	scenario
geed	feed
shipr	ships
js	is
as	am
chrisrmas	christmas
fuuny	funny
peaple	people
peopke	people
sioting	sitting
loneli	lonely
toat	boat
skell	skull
coue	blue
he	hi
shrship	worship
liitle	little
adtached	attached
om	on
deelings	feelings
relaxong	relaxing
brigh	brige
ced	red
she	the
posititionsd	posititioned
tine	time
tip	top
worh	work
warer	water
inlt	onlt
goode	goose
had	has
sa	in
an	aa
gloudy	cloudy
withpick	withpink
eill	will
persorms	performs
olease	please
bots	boys
og	of
sress	dress
phonograph	photograph
stanfdng	standing
witting	sitting
my	me
rooleiflex	rolleiflex
gice	give
millow	yellow
be	by
firl	girl
res	red
c	i
buscuits	biscuits
pein	skin
cuew	crew
od	of
oiding	riding
grren	green
rotal	total
aost	post
yhe	the
t	a
bicysle	bicycle
tight	light
se	in
i	a
ded	red
blur	blue
puszled	puzzled
betwwen	between
dirturb	disturb
greee	green
haveng	having
fouring	pouring
neink	think
wyh	why
beauti	beauty
flolers	flowers
no	is
ond	and
byoking	looking
hailstrom	hailstorm
mt	my
toll	tell
behing	behind
longly	lonely
yo	to
son	sun
oloudy	cloudy
animake	animale
silapidating	dilapidating
an	on
nan	man
has	had
itm	rom
geels	feels
iou'	you'
bacious	various
t	a
huee	huge
n	i
persdn	person
danages	damages
disigned	designed
sonf	song
slosed	closed
comlowing	following
honny	honey
cirls	cicle
ypu	you
womewhere	somewhere
dooe	dude
brighe	bridge
cocered	covered
h	i
bu	by
snale	snake
ins	its
o	n
bice	nice
brak	beak
along	alone
py	my
fiant	giant
top	cap
ictually	actually
neet	neat
philisophy	philosophy
livers	lovers
cood	good
sust	just
heavb	heavy
galling	falling
traveeling	travelling
studd	stuff
lolor	color
tho	two
esge	edge
strret	street
sish	fish
liaves	leaves
pwo	two
nafe	life
busc	bunc
rorested	forested
liotle	little
strnding	standing
frandenstein'	frankenstein'
laww	lawn
t	a
byke	bike
ind	and
imorotant	improtant
firl	girl
buildong	building
goong	going
ot	of
ofan	than
isow	know
coustumers	coustomers
wook	look
watee	water
it	at
dall	wall
thar	that
wiyh	with
lay	may
thia	this
shims	swims
monring	morning
briwn	brown
mily	milk
organined	organised
ieally	really
wodden	wooden
dide	side
wow	how
aquariam	aquarium
tan	can
lonelt	lonely
cace	face
dring	drink
yous	dogs
bery	very
knoe	know
later	layer
dea	tea
yewlow	yellow
pegeons	pigeons
tr	is
ans	and
at	as
sity	city
astack	attack
parbed	barbed
hoe	how
dont	don'
sprcied	species
dragonguy	dragonfly
brrdge	bridge
tofay	today
ie	we
cilling	killing
beckground	background
rating	eating
ne	on
scen	seen
foor	door
plowers	flowers
ye	he
w	a
bhe	the
tide	ride
h'	i'
nood	good
potion	motion
dully	fully
movile	mobile
byeatifull	bueatifull
cols	cold
structurel	structural
tis	his
wull	will
flyes	flies
croos	cross
clise	close
min	man
wity	witu
rode	ride
sloating	floating
relatices	relatives
orgs	orbs
sressed	dressed
sniakers	sneakers
nan's	man's
fil	ful
ihe	the
deautures	feautures
onst	obst
buimy	gummy
in	on
plating	playing
memoyry	memmory
eop	top
pwopl	peopl
add	odd
move	love
workd	world
walhing	walking
pancil	pencil
forst	first
behond	behind
e	a
beautofully	beautifully
skylime	skyline
thourgh	through
amways	always
besutiful	beautiful
sereral	several
od	of
sany	many
woamen	wooden
ahve	have
nest	next
frw	few
sa	so
add	odd
dofs	dogs
mw	me
thny	many
ske	ice
do	am
it's	he's
ready	reads
ias	has
art	are
lhem	them
faster	father
wat	eat
i'wl	i'll
fice	five
freat	great
oof	off
pird	bird
dront	front
un	in
shat	that
plower	flower
yhy	why
ballopn	balloon
clost	close
perfecr	perfect
todards	towards
nowody	nobody
works	worls
wasks	walks
fielfs	fields
lige	like
trist	trust
ir	or
along	alone
liall	small
dody	body
lery	very
bhe	the
seloing	selling
selver	silver
pleced	placed
woe	are
babbanna's	bannanna's
gerson	person
ahe	the
ahe	the
mll	all
shashore	seashore
ofer	over
si	is
junping	jumping
contruscing	contructing
flimgin	climgin
tradinaonal	traditional
arey	they
orante	ornate
bires	birds
streey	street
nare	rare
mwn	man
signla	signle
oeople	people
rlass	glass
cogfee	coffee
fur	our
beauti	beauty
ws	is
snoe	snow
wt	it
facourite	favourite
women	woman
shamr	shame
reapot	teapot
pershed	perched
sine	some
afterboon	afternoon
anso	also
tis	his
muber	nuber
sm	am
ths	the
hsuse	house
g	i
fromt	front
od	of
to	do
handing	hanging
bict	bicy
malp	lamp
barrot	carrot
prople	people
ris	his
ac	am
vatious	various
dhe	the
wa	in
our	you
dide	side
itimbing	climbing
masic	music
bestrument	instrument
thsting	testing
toiay	today
in	on
plasyics	plastics
backgriund	background
not	nor
crows	crowd
worma	worms
fay	day
seting	geting
anoyher	another
ait	air
tomantic	romantic
wt	it
defitetly	definetly
eill	will
con't	can't
writter	written
fifferent	different
myseld	myself
affort	afford
catterpillar	catterpiller
neme	name
clousy	cloudy
jusy	just
smaal	small
near	next
menple	people
is	in
drings	drinks
sidturn	disturn
ypu	you
ehe	the
keptsn	keptin
gave	have
on	in
ne	me
wown	down
thet	that
wvery	every
wilding	holding
dowards	towards
t	a
glouds	clouds
transfoemer	transformer
gady	lady
cansy	candy
whll	wall
oeople	people
fic	fix
while	white
shoul	shall
wooden	wooded
ahis	this
sranding	standing
thei	that
mainting	painting
siz	six
siiting	sitting
veen	been
thf	the
os	is
eysa	eyse
so	am
teken	taken
flrds	birds
skiline	skyline
nest	next
leafe	leafs
oncause	because
aoys	toys
bard	bark
ha	is
inage	image
soccor	soccer
packpack	backpack
practicd	practice
puoud	proud
twentiwth	twentieth
shou	show
wuth	with
ofhers	others
yoman	woman
tcene	scene
upen	open
bew	new
it	is
lolking	looking
w	i
crows	crowd
wel	wil
pard	band
uneque	unique
pingle	single
gahtered	gathered
toyu	toys
awaying	swaying
boars	boats
petter	better
od	of
cannl	canal
is	us
whick	which
p	i
emergeng	emerging
s	a
boe	bee
id	is
wn	in
bodu	body
dor	for
t	a
givinm	giving
feathres	features
thr	the
ets	its
yhrs	yars
civing	giving
tepresenting	representing
ihot	shot
ties	tied
woulb	would
vs	as
hourney	journey
drees	dress
lvfe	life
qeautiful	beautiful
brdige	bridge
a	i
pattin	puttin
deepneds	deepness
ugle	ugly
ard	are
lhose	whose
doong	along
daady	daddy
forehear	forehead
haried	haired
ssimming	swimming
amed	need
uou	you
wcene	scene
dad	bad
ssratch	scratch
vert	very
blosumed	blosomed
ane	one
mt	my
suir	suit
to	do
okd	old
pivie	movie
clink	click
atttaction	attraction
aer	her
lasy	last
fell	fall
core	here
plave	place
anu	any
plann	plane
l	a
stoll	still
insent	insect
faverte	favrite
ia	in
would	could
socccr	soccer
yeag	yeah
clethes	clothes
taining	raining
lmall	small
enhine	engine
playinh	playing
tn	on
spop	stop
i	a
t	a
puctured	pictured
cusy	busy
antiwue	antique
actualll	actually
eberywhere	everywhere
anp	top
standung	standing
yaxht	yacht
rountain	mountain
ctach	catch
rolleuflex	rolleiflex
ioolish	foolish
thg	the
siiting	sitting
thes	this
yhy	why
to	do
boss	loss
tngine	engine
aur	our
tooe	take
she	the
hpen	open
veautiful	beautiful
mmters	maters
immerswd	immersed
piolt	pilot
swiining	swimming
mj	my
outsit	outfit
sf	of
plople	people
oi	on
beaitiful	beautiful
sepairing	repairing
basktop	desktop
lightuouse	lighthouse
panelsd	paneled
fill	will
iomeone	someone
ome	one
amomgst	amongst
lho	who
its	it'
she	the
gove	give
goaveme	leaveme
thing	think
doung	doing
loilding	building
sf	of
lokk	look
moman	woman
wjll	wall
lolicemen	policemen
joingng	joining
danceng	dancing
nen	men
aur	our
putrol	petrol
paly	play
waeping	weeping
liftle	little
sneelength	kneelength
vonstruction	construction
woth	with
f	m
thoow	throw
auroplane	aeroplane
iz	it
carraes	carries
differbt	differnt
jrts	jets
huet	hurt
wp	up
saby	baby
dusr	dust
sit	cut
bu	by
yollow	yellow
mu	my
bu	by
geautiful	beautiful
stooping	stopping
in	on
aiece	piece
whrough	through
s	a
tntensil	untensil
oae	are
nont	dont
baltle	battle
mebacing	menacing
smow	snow
work	word
thaa	that
gegular	regular
feah	heah
wo	to
sant	want
seee	seen
seei	seen
sird	bird
uellow	yellow
up	us
cee	see
reclise	recluse
good	food
orand	grand
gign	sign
sone	some
tverlooking	overlooking
wonan	woman
oce	ice
u	i
chaors	chairs
cm	am
handiug	hanging
contrts	congrts
travelotor	travelator
srop	drop
flass	glass
carvinal	carnival
glags	flags
sra	sea
retrwever	retriever
gooks	looks
ond	and
pooholers	potholers
creing	crying
bloe	blue
hatbour	harbour
sp	so
trom	from
whar	what
rad	red
crows	crowd
hurngy	hungry
foe	for
booki	books
angey	angry
bicle	cycle
tar	car
whaterer	whatever
blacket	blanket
iy	my
oje	one
guymy	gummy
thisg	thing
stuufed	stuffed
asry	very
thier	their
wutu	witu
sailinf	sailing
harde	large
ger	her
vlosed	closed
way	joy
havev'	haven'
itmbers	numbers
most	mist
tike	like
apme	home
cock	lock
aiding	riding
og	of
sesious	serious
overlaoking	overlooking
bourist	tourist
gly	fly
turquise	torquise
srain	train
while	whole
vioks	looks
imse	buse
taves	loves
ahe	the
aust	just
lea	tea
chilw	child
shite	white
aou	you
pnd	end
frusteted	frustated
guch	much
bee	see
doeen'	doesn'
beautifylly	beautifully
gos	god
cant	want
wi	ti
destruy	destroy
oround	around
form	from
paid	pair
imjortance	importance
your	youk
evill	still
stardist	stardust
do	so
bycucle	bicycle
vbaloons	balloons
omd	old
uo	up
ore	are
os	of
beople	people
rode	ride
thousend	thousand
lisard	lizard
w	a
picycle	bicycle
forgor	forgot
unbrellas	umbrellas
freen	green
tine	line
men	oen
nouth	mouth
tne	one
hoside	beside
thrpugh	through
soung	young
standind	standing
cas	was
ohat	what
whcker	wicker
poardwalk	boardwalk
ligtle	little
ladu	lady
ftrutctures	strutctures
od	of
weating	wearing
rooo	room
an	in
stome	stone
anb	any
lulbs	bulbs
to	in
weach	beach
tn	an
kike	like
onto	unto
ahe	the
m	e
dreesed	dressed
prrve	prove
lolor	color
beauttful	beautiful
sesigner	designer
ladyes	ladies
wonfer	wonder
snowbourder	snowboarder
dishes	fishes
cigaratte	cigarette
hlow	blow
stanifing	staniding
cuch	such
monstar	monster
bycycle	bicycle
tnow	snow
non	now
sbove	above
tantastic	fantastic
done	don'
lonelt	lonely
hodby	hobby
lessoi	lesson
wirwork	firwork
whote	white
ballon	baloon
ane	are
theie	their
toautiful	beautiful
twam	team
afo	ago
eveeeone	everyone
tougue	tongue
fot	for
beatuful	beutiful
pyaying	praying
clack	black
soing	going
stynts	stunts
th	to
linht	light
pligible	eligible
lithts	lights
being	going
oiu	oil
stanfing	standing
wuiet	quiet
gird	bird
tegs	legs
iead	head
irs	its
friemds	friends
texteng	texting
liver	lives
vicy	bicy
cancdian	canadian
interestinf	interesting
ob	on
danxe	dance
brihge	bridge
cypewritter	typewritter
lads	lady
arme	arms
hesting	resting
cant	can'
aer	her
thhre	there
or	of
putpies	puppies
flyiig	flying
muaic	music
resding	resting
tid	did
kike	like
iuperb	superb
wan	was
syn	sun
umbreala	umbrella
naght	night
aompletely	completely
peking	poking
mushwoom	mushroom
os	is
hcke	make
hapanese	japanese
dancxs	dances
hellcopter	helicopter
oike	like
aharacters	characters
ib	in
tre	are
gamr	game
bmart	smart
wan't	don't
feild	field
dheet	sheet
bertainly	certainly
ballon	baloon
if	of
ar	or
huice	juice
ire	are
helocopter	helicopter
workh	worth
brautifull	beautifull
papar	paper
on	in
ahe	the
ttay	tray
live	love
in	is
y	n
u	i
susuki	suzuki
ti	to
fefor	befor
os	is
tecause	because
tabke	table
ter	her
beforestgrting	beforestarting
iails	sails
nighy	night
abiut	about
foes	goes
galrry	galary
daady	daddy
at	it
t	a
beak	beat
ahe	the
then	than
belp	help
didturp	disturp
habe	have
shite	white
thown	brown
sleepimg	sleeping
puch	push
dhadow	shadow
oarliamentary	parliamentary
traircase	staircase
astonoshment	astonishment
an	on
slat	flat
carage	garage
pitrure	picture
scenary	scenery
whote	white
ie	me
lok	lik
eith	with
fop	top
ywo	two
id	is
buffalw	buffalo
parahcut	parachut
transaortation	transportation
oerson	person
arunf	arund
msmmy	mammy
myst	must
az	an
site	sits
by	be
in	on
sailboar	sailboat
ar	or
opu	pul
phadow	shadow
gardened	gardener
antone	anyone
wases	waves
t	a
in	on
bed	red
boty	body
fifferent	different
aling	along
imaga	image
grqss	grass
phe	ple
whxt	next
sife	life
on	in
commng	coming
rew	red
crting	trying
tiw	how
io	to
isn	man
wisible	visible
ietter	better
houses	horses
playts	plants
kide	hide
stagete	statute
acound	around
avoustiv	acoustiv
rign	sign
ntanding	standing
captial	capital
ie	we
shaped	shapes
amn	man
sime	some
ememy	enemy
weed	feed
apop	atop
ehy	why
bariccades	barricades
aouse	house
zleep	sleep
ome	one
freen	green
salas	salad
unmanded	unmanned
ditting	sitting
goldola	gondola
seem	seen
abound	around
af	of
ptoceeding	proceeding
land	hand
singe	since
fluing	flying
it	is
snnwy	snowy
surcus	circus
yellowsh	yelloish
whire	white
t'm	i'm
thr	the
beautigul	beautiful
enioying	enjoying
lians	leans
axactl	exactl
aoney	money
tnd	and
scaru	scary
by	my
yniformed	uniformed
canel	camel
hacing	having
tlosing	closing
soo	too
smim	swim
an	am
wull	full
swrmmers	swimmers
hjm	him
olease	please
coand	brand
thta	data
nobidy	nobody
firl	girl
girm	girl
woat	beat
everyehere	everywhere
rolle	rolls
sou	you
if	of
buttergly	butterfly
hilding	holding
ceep	keep
palced	placed
on	do
ofer	over
leave	leafy
ehe	the
saer	waer
aith	with
gome	home
wingow	window
ahere	there
scasred	scacred
tem	tea
folor	color
poats	boats
og	of
gh	oh
she	the
earing	eating
tn	in
hipe	hope
gall	wall
thfough	through
shair	chair
while	white
tircus	circus
ssen	seen
glive	olive
aon't	don't
ioere	there
smow	snow
rublic	public
mauntain	mountain
pther	other
me	my
ti	to
duolicate	duplicate
acroos	across
wathways	pathways
rur	fur
cofa	sofa
domt	dont
restiog	resting
birg	bird
ypung	young
persin	person
oy	my
place	plane
hon't	don't
habd	hand
rold	role
brool	brook
warer	water
candie	candle
workd	world
t	a
wne	one
tor	for
ginished	finished
woing	going
tacing	racing
w	a
basy	baby
tooing	toeing
pleese	please
oackground	background
wioh	with
yoong	young
umprella	umbrella
gor	for
delicioud	delicious
tne	one
putterfly	butterfly
sid	sit
cifaretter	cigaretter
boars	boats
our	out
ine	the
cam	can
ctick	stick
bweautiful	bbeautiful
pwople	people
sunloght	sunlight
winfoe	windoe
is	it
haie	hair
fron	from
out	put
stade	slide
showi	shown
plating	playing
iow	tow
abondoned	abondened
bredge	bridge
goiig	going
wiyhbeautiful	withbeautiful
wasks	walks
sname	snake
floowrs	flowers
dostance	distance
lookink	looking
realxable	relaxable
acrocs	across
cuty	city
waering	wearing
walkibg	walking
tmpty	empty
flowere	flowers
focuusing	focussing
wlimbing	climbing
t	y
holde	holds
diet	dirt
nan	man
holdong	holding
os	of
ling	long
watel	water
ioring	boring
beautifuk	beautiful
od	of
pait	pair
cre	are
it	at
hear	hair
ipen	open
teed	need
brautiful	beautiful
lokking	looking
throwes	throwed
od	of
wauid	fluid
disappoinged	disappointed
handing	hanging
frain	frame
rlue	blue
throwgh	through
ind	and
counfield	cornfield
persoms	persons
hunging	hanging
ahe	the
ie	is
furnituye	furniture
feautiful	beautiful
sise	side
faet	fast
coutumed	costumed
atanding	standing
inmething	something
reses	rises
wowards	towards
vock	rock
of	in
skil	skin
on	in
lote	more
lery	very
suppert	support
trumper	trumpet
liiking	looking
horse	house
wwlk	walk
iy	by
tehre	there
decordtes	decorates
mn	in
hundeards	hundreads
ar	at
cirur	chaur
places	placed
itr	her
itationed	stationed
seap	deep
togey	bogey
oeople	people
bithfay	bithday
colorid	colored
veems	seems
stopppng	stopping
inslite	inspite
ao	so
useng	using
kike	like
know	knot
got	get
ate	are
dooo	door
sjy	sky
skean	clean
mobe	move
brod	food
rhe	the
lolking	looking
breating	creating
chane	chain
spaped	shaped
brigate	brigade
same	save
whens	who's
noe	now
mast	most
worls	world
mt	me
id	is
lomely	lonely
buautiful	beautiful
singlr	single
he	ha
folden	golden
snd	and
forwver	forever
whu	who
thr	the
blowe	blows
neae	near
ihe	the
sog	dog
tellow	yellow
place	plane
rink	pink
vooking	looking
generius	generous
in	on
sprprice	surprice
conering	covering
ctate	crate
wirl	girl
dist	dish
wicrophone	microphone
popolarity	popularity
hts	its
unbrella	umbrella
theur	their
pearing	peering
couse	house
sloating	floating
rarly	early
rose	rope
sedurity	security
mais	this
glaas	glass
windes	windex
scientish	scientist
wie	are
carelully	carefully
hook	look
tave	give
rellly	really
fruend	friend
tommottow	tommorrow
tht	the
swarm	swarn
on	in
bad	bag
shoeing	showing
heip	help
facind	facing
thibgs	things
tn	an
oversast	overcast
yll	all
wilh	with
firemen	fireman
iut	put
stanbing	standing
t	a
un	in
foof	food
ine	one
im	am
camere	camera
isere	there
noe	now
pary	park
boww	bowl
aungry	hungry
onrly	early
n	a
lokking	looking
an	on
nusic	music
biid	bird
warch	watch
forect	forest
umbreala	umbrella
tater	water
w	i
bach	back
snoa	snow
c	b
per	pet
id	is
awinging	swinging
frendh	french
passesgers	passengers
groung	ground
wiw	wow
ullusion	illusion
containg	contains
fingure	fingers
fiew	view
biats	boats
od	of
loe	lve
t	i
b	a
ar	of
aee	see
cplash	splash
chind	child
covereng	covering
food	good
foorball	football
my	me
feally	really
asainst	against
yhis	this
ane	are
in	on
pumplin	pumpkin
marge	large
favoi	favor
pallce	palace
poeple	people
thid	this
c	i
moman	woman
sppons	spoons
forrst	forest
comr	come
bast	past
splaching	splashing
giod	good
racky	rocky
tvsevisions	televisions
motorcyele	motorcycle
un	in
bvrd	bird
oiding	riding
ot	of
girlfriens	girlfriend
vus	bus
c	a
wit	sit
vollecting	collecting
abay	away
probablu	probably
peacefuk	peaceful
narroe	narrow
hiat	that
greay	great
pwople	people
anoinst	against
bracr	brave
in	is
wew	wow
rizer	razer
wed	red
vailed	veiled
od	of
d	a
pucture	picture
thinks	things
sheck	check
uou	you
ninter	winter
strioed	striped
ond	and
lighet	lighed
mornung	morning
thos	this
bire	bird
ib	so
bu	by
an	am
peacefukl	peacefull
itrson	person
arange	orange
gitl	girl
playong	playing
fords	birds
hent	tent
watchinf	watching
glag	flag
plug	pluk
rulr	rule
caby	baby
on	in
stowing	growing
wien	open
reuntains	mountains
cldan	clean
offere	offers
mhis	this
ona	one
tn	in
htis	this
thirdy	thirty
chrsitmas	christmas
dovk	dock
riging	riding
announcemenrs	announcements
tearing	hearing
railcoat	raincoat
totating	rotating
stines	stones
lolorful	colorful
gridge	bridge
draving	driving
goinf	going
abserving	observing
nest	best
on	in
sneek	sneak
sage	safe
al	me
enjoyimg	enjoying
stooted	spotted
dn	on
bous	boys
mattied	married
filed	field
crpwd	crowd
ans	and
calking	walking
ehite	white
fraaly	freely
erite	write
sweam	steam
wqual	equal
caredul	careful
lnchored	anchored
evefywhere	everywhere
flom	farm
dider	rider
an	in
vefore	before
fefore	before
vissble	visible
hes	his
ana	and
aose	rose
aitting	sitting
oeople	people
forger	forget
ahve	have
adfp	atop
wny	any
fluing	flying
teo	two
cage	cafe
brandh	branch
gorgot	forgot
gor	for
whown	shown
ale	are
jyst	just
wh'	we'
in	on
v	a
toming	coming
whitw	white
preen	green
calking	walking
infian	indian
alsays	always
olgn	sign
os	is
wehicle	vehicle
camoglague	camoflague
beoad	broad
agter	after
abry	very
leally	really
books	boots
balck	black
sprials	spirals
ihis	this
opject	object
sooking	looking
fron	from
therry	cherry
shy	sky
ht	it
sitttng	sitting
t	a
waitiog	waiting
os	is
sown	down
snall	small
w	i
balck	black
ceep	keep
toe	the
jontested	contested
on	in
vsed	used
stby	baby
iut	but
wwtching	watching
d	i
yobng	young
mews	news
swimiing	swimming
hazing	gazing
ti	to
wisitors	visitors
eou	you
neily	daily
stanning	standing
tha	the
dhis	this
hort	hart
pland	grand
roubd	round
swem	swim
eny	any
swveral	several
par	car
eill	will
gea	sea
averyone	everyone
toprism	tourism
benind	behind
o	i
an	on
chesp	cheap
cottagr	cottage
cououred	coloured
kike	like
mando	mango
t	a
seay	very
ennoy	enjoy
awar	away
min	man
sisen	risen
gracks	tracks
saen	seen
spe	are
oner	over
bycicles	bicycles
amd	and
fdr	for
ower	over
aonely	lonely
thy	boy
beautoful	beautiful
gnms	gems
taste	tasty
takeng	taking
dlap	flap
pag	bag
wont	won'
ahe	the
in	on
mockflip	backflip
if	of
aith	with
mne	one
th	to
ypung	young
nhy	why
sfiter	loiter
tge	the
farr	farm
whose	those
hrart	heart
zoomes	zoomed
helixopter	helicopter
nerer	never
a	s
mirroe	mirror
dencing	dancing
wnough	enough
ghe	the
ws	as
noe	are
tellow	yellow
a	i
onwarts	onwards
mu	is
lokks	looks
meka	make
ot	or
an	in
gitl	girl
live	love
nirger	burger
secutity	security
iooks	looks
gigars	cigars
tyoe	type
men	mea
ui	is
swil	swim
stm	dam
rhis	this
but	buy
i	a
ihis	this
shair	chair
momen	women
t	a
brassburn	grassburn
flaoting	floating
shoq	show
wiw	wow
hibertates	hibernates
on	in
iverywhere	everywhere
lsdy	lady
woe	bye
bout	bouy
mmn	man
evering	evening
canorful	colorful
an	on
nkce	nice
perers	peters
glasser	glasses
somebodys	somebody'
vn	in
tmerging	emerging
thi	the
vomplectly	complectly
chip	ship
mt	my
tight	night
ghat	what
loke	like
gim	him
whn	whe
iverone	everone
soke	some
bycle	cycle
in	on
drom	from
ianging	hanging
aherries	cherries
mleasent	pleasent
it	is
bysle	cycle
caughy	caught
pancils	pencils
colorgul	colorful
ohere	where
amall	small
cuty	city
am	in
tim	him
lie's	lay's
beautifil	beautiful
coverer	covered
in	on
firsting	bursting
cucles	cycles
ir	it
evenibg	evening
butterflt	butterfly
os	is
birl	girl
ob	on
s	a
we	it
kady	lady
pongle	single
wow	cow
be	ne
eacg	each
case	vase
eberythin	everythin
gey	hey
fokm	form
orher	other
stanfing	standing
uding	using
id	is
nark	dark
botlle	bottle
femaie	female
bow	how
dont	don'
bhich	which
ruuning	running
sheesecake	cheesecake
i	a
tittle	little
iaving	having
peeking	peeping
dover	never
nest	next
descussing	discussing
freak	break
damce	dance
pack	pick
wower	tower
form	from
stonw	straw
maintanande	maintanance
fuve	five
birt	bird
fray	pray
atmospehric	atmospheric
yeloow	yellow
ferry	merry
streen	street
granly	gnarly
sesrch	search
founf	found
shoaow	shodow
mor	for
uou	you
giamt	giant
mw	me
af	of
aross	cross
aeash	leash
aary	army
keeo	keep
it	at
fot	for
scenec	scenic
technigues	techniques
bly	fly
mow	now
chiness	chinees
vup	cup
vus	bus
con't	don't
os	is
srarring	starring
un	in
cmoing	coming
itr	its
arossed	crossed
ie	me
ambrella	umbrella
buildon	buildin
t	a
prople	people
fhrough	through
potata	potato
bachground	background
nect	next
dover	doves
shirt	skirt
irom	from
sisturb	disturb
ao	do
congres	congrts
firl	fire
ghe	the
whay	what
vertacal	vertical
brokrn	broken
teo	two
smail	snail
coveded	covered
lift	left
planform	platform
selevted	selected
id	is
baughing	laughing
iubbles	bubbles
sey	hey
dt	ot
lijht	light
lom	i'm
wheee	wheel
fiedes	riedes
io	so
gatherou	gathered
aoats	boats
ind	and
s	m
iut	but
wa	on
flies	flyes
ehere	where
gooking	looking
be	by
plauing	playing
crayiis	crayons
anong	along
stane	stage
trop	drop
dog	big
gridge	bridge
commom	common
rerror	terror
ans	and
beautyful	beautiful
ctach	catch
blie	blue
hace	have
glower	flower
sped	shed
fanily	family
bly	fly
saiting	waiting
aolice	police
wi	on
tires	tyres
ob	on
volour	colour
frieng	friend
volourful	colourful
reana	arena
aeveral	several
baxket	basket
ig	is
lade	lady
tut	but
d	a
ny	my
fie	die
parks	paths
ab	an
thshing	pushing
tooking	looking
kever	never
rhe	the
beautiiul	beautiful
hespiest	happiest
thest	these
ohters	others
colout	colour
gight	fight
tress	trees
thet	that
balck	black
bot	not
cpuple	couple
boar	boat
oitting	sitting
domimo	domino
libe	live
thich	thick
shis	this
preety	pretty
coty	city
say	day
t	i
han	can
at'	it'
places	placed
whire	white
viilage	village
teh	two
shich	which
nahionable	fahionable
briwn	brown
fub	fun
tast	past
uo	up
pasa	pass
pill	pull
shich	which
is's	it's
silente	silence
guesta	guests
cure	cute
salicious	delicious
fluit	fruit
thar	that
phite	white
trime	crime
snawman	snowman
ahineese	chineese
ti	to
aight	night
gatherdi	gathered
dur	dog
miggle	middle
himseld	himself
sovks	socks
notorcyclist	motorcyclist
facorite	favorite
blass	glass
sparkkes	sparkles
lloks	looks
ti	to
chte	cute
alcoholcs	alcohoics
enyoying	enjoying
showlaces	shoelaces
moror	motor
foeld	field
backetball	basketball
nwverending	neverending
in	on
ricks	rocks
wsimming	swimming
profice	provide
smooing	smoking
adead	ahead
weering	wearing
dmoking	smoking
faeld	field
sudge	fudge
ghrouds	shrouds
dram	dran
cervertible	convertible
iy	my
ou	at
slige	slide
hsvbe	havbe
frainers	trainers
ms	is
rhis	this
t	a
wweat	wheat
wquared	squared
oll	all
anerces	pierces
magesty	majesty
wow	how
onto	into
linnd	lined
begind	behind
tearned	learned
on	in
movung	moving
bry	dry
o	i
thes	this
aim	iam
lapbook	macbook
biat	boat
frees	free'
a	i
qnique	unique
aird	bird
tha	the
hot	how
onanding	standing
c	a
takinh	taking
moodi	moody
clam	calm
wodden	wooden
firl	girl
blad	bird
suns	sits
was	has
eith	with
hes	his
hoppy	happy
bityle	bicyle
talkinf	talking
ine	one
dreas	dress
dadydy	dadddy
ter	her
vowls	bowls
peoepy	peeepy
ladys	lady'
gons	guns
comm	come
hwy	hey
luggase	luggage
beautyful	beautiful
in	on
tver	over
rodk	rock
spherucal	spherical
s	a
whilw	while
cascasing	cascading
whst	just
lf	of
perdon	person
dad	did
acrocs	across
havc	have
in	on
ofe	one
somethjng	something
eake	take
frnce	fence
wow	how
parenrs	parents
sjot	shot
everythinf	everything
wiltting	wiitting
groung	ground
moad	toad
ming	mind
landsacpe	landscape
daffodols	daffodils
bolloon	balloon
ballong	ballons
to	do
tht	the
baceside	backside
enginner	engineer
shunder	thunder
ahe	the
wlass	glass
nunch	bunch
pistil	pistol
whe	the
oens	owns
whd	and
madding	wedding
aplashes	splashes
nit	not
wanish	vanish
nvctar	nectar
mucj	much
womderful	wonderful
uo	up
streee	street
surging	surfing
aive	give
tes	yes
thwowing	throwing
workwrs	workers
soldierw	soldiers
workd	world
edgt	edge
blying	flying
in	on
graxing	grazing
pannenger	passenger
ihank	thank
ctreet	street
buildong	building
anf	and
iummy	mummy
eacercises	excercises
aeveral	several
perhspa	perhaps
jot	not
uniqye	unique
amde	made
woll	will
dividen	divided
younk	young
fron	from
monts	monks
ve	we
swimgs	swings
tne	one
escapr	escape
everypn	everyon
hvae	have
pther	other
kave	have
oranfe	orange
crea	area
o	i
douse	house
aoffee	coffee
dau	day
confortable	comfortable
purpoe	purple
oucture	picture
while	white
wur	our
ond	and
grren	green
diffifulty	difficulty
id	is
wayer	water
itherwise	otherwise
whry	very
fridnd	friend
speal	speak
b	a
k	i
wery	very
wo	go
re	we
mothon	motion
oitting	sitting
prosoners	prisoners
bed	red
spee	free
c	a
livley	lovley
loooing	looking
farning	farming
golder	golden
chease	cheese
s	a
cvn	can
is	it
lighr	light
did	kid
bights	lights
celebtation	celebration
cupsake	cupcake
unbrella	umbrella
in	on
tackesg	tacking
didficult	difficult
eage	edge
iolice	police
forent	forest
boviously	obviously
killlr	killer
at	on
gret	grey
ate	are
larde	large
yallow	yellow
ypside	upside
inaring	wearing
smokeng	smoking
collest	coolest
vivible	visible
stee	step
buciets	buckets
sleppy	sleepy
captures	captured
begind	behind
wery	very
thj	the
ann	and
shuitle	shuttle
enjouing	enjoying
mych	much
th	of
handa	hands
suceess	success
thourh	though
plene	plane
w	a
ns	is
plaved	placed
artifiaially	artificially
stucfed	stuffed
might	night
skue	blue
lhe	the
ao	so
like	lake
tye	the
women	woman
wddly	oddly
machinery	machinary
while	white
ioday	today
pmbracing	embracing
th	to
ham	iam
siscussing	discussing
goll	doll
dessrt	desert
b	i
orad	road
nadakali'	kadakali'
bires	birds
forfive	forgive
whather	weather
nooks	books
rhe	the
unside	inside
vable	table
oxyfen	oxygen
bildings	buldings
dy	my
hes	his
whinking	thinking
gow	how
din't	don't
sname	snake
workd	world
thise	those
rhere	there
fet	get
timl	till
roae	rose
nany	many
neauty	beauty
seautiful	beautiful
mt	my
spspended	suspended
uellow	yellow
refinary	refinery
earfuffs	earmuffs
sick	sits
ate	are
climbilg	climbing
nade	made
s	a
looted	booted
beown	brown
lightining	lightening
tha	the
swinming	swimming
anttnna	antenna
rape	rope
ond	and
goave	leave
walling	walking
d	a
whi	why
possebly	possibly
ar	er
o	e
ded	red
misteke	mistake
fastle	fastly
ty	my
ian	iam
frint	front
handing	hanging
tolled	rolled
your	you'
roadsice	roadside
whice	white
oi	on
gioe	give
aoom	room
mestr	bestr
dot't	don't
goung	young
walling	walking
inpressed	impressed
sime	some
mon't	don't
resrarch	research
ro	to
liquou	liquor
nou	you
hylding	holding
worderfull	wonderfull
ofer	over
brach	beach
ofer	over
evetything	everything
cummer	summer
neespapers	newspapers
whats	thats
t	i
beide	bride
plying	flying
troup	troop
isaring	wearing
builging	building
witl	will
beautigully	beautifully
ro	to
photosrapher	photographer
tno	two
noe	now
mmtorize	motorize
ie	it
ppol	pool
in	on
clns	mens
tntil	until
blinkink	blinking
tool	took
nit	not
aslkep	asleep
ane	one
toe	the
haye	have
my	oh
convrete	concrete
hakf	half
enjou	enjoy
tim	tie
samrtly	smartly
grren	green
ohones	phones
gocking	jocking
graen	green
mioutes	minutes
beautyful	beautiful
thr	the
pleaent	plesent
vlue	blue
whth	with
froup	group
appluing	applying
bitth	birth
habd	hand
im	in
ewite	white
veileve	beileve
ander	under
exviting	exciting
plating	playing
bit	big
hade	hate
oa	on
watet	water
lended	landed
og	of
ans	and
iher	ther
wiman	woman
wadless	endless
showow	shodow
bery	very
uo	at
rais	runs
thite	white
naulpain	nailpain
shipp	ships
m	i
smve	have
s	a
smooing	smoking
skyll	skull
botorbike	motorbike
iarge	large
fornt	front
habe	have
smage	image
atrawberries	strawberries
sre	are
taiding	raiding
ganior	junior
lulips	tulips
arr	are
ihis	this
bots	boys
cace	race
chifrends	chidrends
snall	small
dan	man
em	am
picnic	picnik
p	a
in	on
rainbor	rainbow
nhotography	photography
waeet	sreet
mucic	music
challenced	challenged
parced	parked
someonet	someonei
poes	does
wakilg	waking
nelp	help
yourg	young
cansle	candle
corousel	carousel
pulding	holding
galsshow	glasshow
an	on
is	to
theor	their
ad	as
on	an
cikourful	colourful
woman	women
is	it
cilour	colour
dalls	dolls
on	in
bicucle	bicycle
awo	two
gs	is
tion	lion
homebady	somebady
yelllw	yellow
ihat's	that's
seafuly	seaguls
circentric	concentric
aear	bear
apolugon	apolygon
bridbe	bridge
unbrella	umbrella
frth	with
cake	make
amustment	amusement
amd	and
fhe	the
h	i
ty	my
id	is
id	is
ilone	alone
siore	store
bucycle	bicycle
ehen	when
vann't	cann't
barger	larger
gane	wine
on	in
teafs	leafs
id	is
stuare	square
care	take
well	full
wone	line
thise	these
gow	how
m	i
mhat	what
fave	have
judhe	judge
sins	sits
cuty	city
loke	woke
snoc	snow
bluar	clear
setergent	detergent
mur	our
codfee	coffee
somewne	someone
rifing	riding
mirroe	mirror
cushiob	cushion
grounf	ground
babel	label
cghnce	cahnce
lal	tal
immtating	imitating
ggrl	girl
boad	boat
strret	street
h	a
coversd	covered
os	is
prive	price
forgoy	forgot
lhat	what
women	woman
dawn	down
frienfs	friends
theie	their
ck	co
yound	young
hish	high
gice	nice
graing	traing
audians	audions
jogind	joging
tip	top
elegent	elegant
plower	flower
sooks	looks
yeelow	yellow
yell	tell
glothes	clothes
wxercise	exercise
hocnic	picnic
stansing	standing
insite	inside
understans	understand
brlm	calm
bacj	back
ezam	exam
oof	off
folled	filled
yow	how
whoch	which
canves	canvas
id	is
anout	about
fges	ages
there	these
withiut	without
proppller	propeller
atanding	standing
wonderlull	wonderfull
tot	not
wh	oh
rufles	rifles
cant	can'
heaning	leaning
cum	cup
abd	and
fo	to
nede	nude
inly	only
hoge	huge
shops	ships
vrchestrating	orchestrating
strawwerries	strawberries
somd	some
at	on
woat	coat
ihi	thi
excalators	escalators
seeing	sesing
twif	twig
enhouing	enjoying
work	worn
ahings	things
cayaks	kayaks
pwo	two
in	on
oyr	our
msall	small
bwtween	between
cubcakes	cupcakes
hea	sea
bubule	bubble
waver	waves
planrs	plants
tat	cat
laises	raises
facor	favor
sou	you
along	alone
amed	need
birgh	birth
aross	cross
mountians	mountains
blach	black
palored	colored
io	do
amd	and
pears	peers
blaid	plaid
ae	we
rolds	holds
heylo	hello
hath	with
airl	girl
titten	kitten
anteresting	interesting
thoking	looking
mhere	there
im	in
there	these
tlong	along
smiming	smoking
maintamance	maintanance
cemon	lemon
engoying	enjoying
lake	like
beats	boats
perple	people
hunfry	hungry
reavh	reach
wne	one
teo	two
bycyucle	bicyucle
lete	lets
dirl	girl
in	is
it	at
burettos	burritos
fletty	pretty
on	in
ffr	far
aook	look
sais	said
biult	built
mire	more
persojm	persons
flyung	flying
engourage	encourage
whivh	which
ingriguing	intriguing
turboats	tugboats
ear	car
gtound	ground
vroud	croud
paiated	painted
ge	be
ond	and
shep	shed
ontique	antique
thes	this
thid	this
founf	found
ans	and
thes	this
feaves	leaves
on	an
beautifyl	beautiful
mye	the
oush	push
hoaloween	halloween
upwn	down
af	of
buge	huge
making	taking
ppople	people
fully	funny
ii	is
abnung	amoung
go	in
sime	time
sycling	cycling
takeng	taking
tawles	towles
tgus	thus
ia	in
uo	no
obressing	opressing
or	of
wn	in
cotterfly	butterfly
sonthing	somthing
ywllow	yellow
ban	man
ian	can
hroses	horses
yoys	toys
marrief	married
niagre	niagra
in	on
bod	boy
herat	heart
fron	from
meoples	peoples
soncert	concert
in	to
ganeeeee	gameeeee
thople	people
takinf	taking
saughter	daughter
myi	thi
dpnt	dont
vlue	blue
bocky	rocky
sbow	snow
reflexted	reflected
chinesse	chineese
fgrl	girl
ie	we
cirsus	circus
kooking	looking
msuhroom	mushroom
sir	sit
nuch	much
wurrounded	surrounded
ovhind	behind
ar	on
aherhead	overhead
birs	bird
s	a
bolorful	colorful
woman	women
rpectacular	spectacular
ge	to
vall	ball
covers	coverd
peeling	feeling
if	of
otposite	opposite
he	we
in	an
thid	this
bycycles	bicycles
nome	some
balive	belive
areo	also
adventrue	adventure
beed	need
birthfay	birthday
merceded	mercedes
tn	in
vietnamere	vietnamese
differeng	differing
an	am
experienxe	experience
stiil	still
beautifil	beautiful
cam	can
cront	front
moman	woman
workd	world
kike	like
wome	some
desplayed	displayed
noy	not
bastet	basket
aquare	square
seren	seven
whwre	where
goin	join
youa	yoga
uou	you
connefting	connecting
stck	rock
gus	guy
d	a
cre	are
foundain	fountain
middlw	middle
ladf	lady
ohotos	photos
praid	braid
enterinining	enteritining
lill	will
bordboard	cardboard
grapfiti	graphiti
othereise	otherwise
flivkering	flickering
finders	fingers
smim	swim
he	on
fests	rests
whhels	wheels
chabge	change
ditting	sitting
swesome	awesome
ihe	the
progession	profession
fllor	floor
filally	finally
lookung	looking
sod	sad
genersus	generous
cee	see
ws	is
dliff	cliff
seld	held
tge	the
slocked	flocked
ty	my
w	i
clrk	dark
toing	going
mire	more
diding	riding
nao	nap
demage	damage
stang	stand
orates	crates
seeling	feeling
noy	now
spondebobe	spongebobe
heaat	heart
beautifyl	beautiful
mcdonalds	mcdonald'
oj	oh
ewo	two
bicyvle	bicycle
sulking	walking
toll	doll
leke	like
honging	hanging
mr	me
keek	kick
auch	such
roogtop	rooftop
auro	aura
enjot	enjoy
thisg	thing
htanding	standing
no	nw
marks	masks
boads	boats
winfow	window
diring	during
ln	in
aooden	wooden
plesae	please
saring	taking
hade	hate
couourful	colourful
bdvertisement	advertisement
mn	in
sha	sea
ballon	baloon
man	may
is	it
ofnning	running
wholw	whole
sac	sax
mou	you
boars	boats
ik's	it's
moshroom	mushroom
himan	human
dot	dog
swileling	swiveling
ballone	baloone
son't	don't
surrunded	surounded
eo	do
anf	and
ang	and
bool	pool
vome	some
ve	we
pld	old
enyoy	enjoy
av	an
itno	into
fetally	totally
workd	world
ihe	the
besided	besides
geautiful	beautiful
turry	hurry
ay	my
birls	girls
ski	sky
oere	were
ialy	ealy
an	it
of	go
fing	find
depected	depicted
fisjes	fishes
kis	kid
passpirt	passport
fubcy	fancy
af	of
stutue	statue
galss	glass
statur	statue
oho	who
qwn	own
relazing	relaxing
woean'	woman'
beautigul	beautiful
sycle	cycle
wlanning	planning
doninoes	donino's
go	do
dont	don'
tome	time
rideng	riding
vus	bus
seim	swim
flolic	frolic
ome	one
gave	have
read	road
kat	cat
fod	and
reding	riding
beautifukt	beautifult
goffy	goofy
sress	dress
boc	box
rellow	yellow
forect	forest
bature	nature
inre	here
slock	flock
takt	wait
fock	rock
there	where
esplain	explain
whire	white
walke	walks
wouldnt	wouldn'
fold	hold
roite	white
ladi	lady
weter	water
gutiat	gutiar
hsr	her
alder	older
aduck	stuck
bith	with
nht	wht
possible	possibly
reke	take
tgings	things
gody	body
saus	says
owster	master
givem	given
ower	over
brid	bird
bredesmaids	bridesmaids
lird	bird
she	the
exidt	exist
im	am
gloseup	closeup
nowody	nobody
eith	with
oft	out
ahe	the
eith	with
scakeboord	scakeboard
eyez	eyes
modek	model
breat	bread
olo	old
gill	kill
handing	hanging
thise	these
relaxlly	relaxily
hoe	how
warn	warm
facourite	favourite
s	t
foshes	fishes
menny	penny
iou	you
planr	plant
areund	around
on	in
solls	dolls
catching	watching
ie	we
freakfast	breakfast
kooking	cooking
overwelmw	overwelms
r	a
quict	quick
lit	sit
avainst	against
charecter	character
th	up
pirettes	pirattes
amny	many
buch	much
ig	if
sisturb	disturb
an	am
yh	th
tathered	gathered
on	in
weddrng	wedding
t	a
flyinf	flying
sishes	fishes
squirell	squirrel
dooren	wooden
comsisting	consisting
lvoe	love
wew	new
joyly	jolly
sittimg	sitting
thate	there
swatberries	stawberries
mu	my
comeng	coming
leavf	leadf
warolling	strolling
vull	full
ligths	lights
io	to
tastung	tasting
ane	one
lill	kill
dully	fully
tough	touch
rarly	early
rea	red
on	in
dirl	girl
oysetrs	oysters
c	a
yeu	you
childree	children
goy	fly
mu	my
jope	hope
backiround	background
photograoher	photographer
amoug	among
pooo	poor
skateboardsrs	skateboarders
puttet	puppet
''ll	i'll
loo	lot
aheir	their
hext	next
prtraying	potraying
soughly	roughly
coverrd	covered
looh	look
effectmy	affectmy
kikes	bikes
shampagne	champagne
bequty	beauty
marriage	marriagi
looing	coming
foing	going
nuilding	building
ans	and
ares	area
loaely	lonely
ti	to
smow	snow
celertation	celebtation
sage	safe
growes	growed
ae	me
ts	is
footbrints	footprints
bequtiful	beautiful
in	on
thar	that
gree	tree
kight	light
yrange	orange
ciming	coming
rrflecting	reflecting
th	my
otill	still
lind	line
armi	army
diding	riding
sinset	sunset
warer	water
kike	like
alight	aright
sittle	little
sen	sun
enjiy	enjoy
eheres	wheres
enjoyinf	enjoying
s	a
an	on
sinset	sunset
lineing	winning
somedody	somebody
beaatiful	beautiful
is	if
tith	with
amed	need
cacing	racing
novody's	nobody's
her	has
ihrough	through
wery	very
on	of
nimerous	numerous
cpulour	coulour
phonos	photos
passed	passes
rating	eating
asound	around
bre	one
shildren	children
beauth	beauty
dood	food
swimmmng	swimming
ms	is
feflection	reflection
flpating	floating
chilc	child
fliding	gliding
bittles	bottles
ts	is
mst	ust
corwd	crowd
liktle	little
cutelt	cutest
pitten	kitten
workhiper	worshiper
cll	all
parth	party
gross	cross
didital	digital
acroos	across
wriitin	written
habd	hand
rake	lake
so's	do's
at	st
sisting	sitting
dunny	sunny
oi	on
hpones	phones
enyoying	enjoying
ihe	the
sracks	tracks
sceme	scene
guve	give
deiven	driven
ti	to
whnk	pink
handed	hanged
dont	don'
mhone	phone
rid	red
thi	the
torn	town
stlye	style
ares	area
oellow	yellow
qhat	what
cith	with
seafulf	seaguls
koints	joints
takeng	taking
tor	for
egcorns	accorns
wveryone	everyone
oltique	antique
efyl	eful
fluing	flying
mocing	moving
us	is
saroounded	sarrounded
scart	scarf
therything	everything
yhere	there
aw	am
dirth	birth
mod	dad
uou	you
isaching	reaching
telethone	telephone
hoe	how
eae	one
as	is
weiting	waiting
tar	car
fore	more
an	on
ar	at
ousic	music
chiness	chinese
w	a
ia	is
watchikg	watching
ahere	there
blaxk	black
tow	how
an	am
sying	lying
whire	white
rescur	rescue
eash	easy
rmbrella	umbrella
keave	leave
ornalental	ornamental
grpw	grow
show	shoe
ie's	he's
srying	trying
kittin	kitten
oerson	person
yo	to
locely	lovely
sunnt	sunny
liave	leave
ihat	what
worls	world
icannpt	icannot
sow	low
wnjoy	enjoy
rrsting	resting
crosds	crowds
wlimate	climate
happyly	happily
bib	big
cjoose	choose
vhis	this
veri	very
snd	and
if	of
ti	to
ib	in
hust	just
sycking	sucking
wiil	will
sn's'	suns'
gridge	bridge
bucycle	bicycle
inder	under
wished	wishes
fornt	front
bridgr	bridge
a	i
towm	town
stans	swans
onr	one
aquariym	aquarium
nut	but
hissing	kissing
fo	to
sheme	theme
eash	each
donfused	confused
cipples	cupples
timm	till
mersons	persons
sjy	sky
lailboat	sailboat
veuy	very
oicture	picture
cardm	carsm
matline	outline
pags	pads
re	is
boatinf	boating
cutr	cute
looj	look
uou	you
barrow	borrow
worls	world
cwo	two
bery	very
puulic	public
lesy	easy
whats	thats
thke	take
vright	bright
vts	its
lebber	rubber
ms	is
bloow	bloom
fowe	foue
bedind	behind
eacj	each
tha	the
as	is
h'm	i'm
palce	place
tha	the
sutting	sitting
bashet	basket
bo	to
ihis	this
kees	keys
wooking	looking
soiders	spiders
stnta	santa
san	can
wse	use
whering	wearing
wisking	risking
women	woman
pept	kept
siver	saver
an	on
anaware	unaware
areo	also
moddle	middle
het	her
class	glass
soad	road
drives	driver
ford	fork
bace	blue
sown	down
on	in
wondow	window
an	am
umbreala	umbrella
tyrws	tyres
decroatively	decoratively
rouared	squared
cao'	can'
plying	flying
chindren	children
wim	win
adversised	advertised
fluffl	fluffy
ak	am
abd	and
tater	water
gow	how
trirling	twirling
wour	your
digns	signs
weargng	wearing
sppkesperson	spokesperson
of	if
amd	and
wotl	work
vandalised	vandalized
af	of
s	a
prednent	pregnent
simething	something
shouldnt	shouldn'
noce	nice
mogging	jogging
ma	me
bu	by
femele	female
wquare	square
sone	some
fressed	dressed
geinking	drinking
amd	and
thise	these
enhoying	enjoying
durfing	surfing
pleaent	plesent
in	so
wloud	cloud
amimal	animal
standinf	standing
n	m
gair	hair
heyty	jetty
festiwal	festivel
tna	sna
lxtremely	extremely
backgounfgray	backgoundgray
climage	climate
i	s
in	on
ballon	baloon
drom	from
uour	your
that	than
firl	girl
alcogoics	alcohoics
t	a
fisherman	fishermen
tomething	something
alome	alone
honds	hands
cololr	colour
aws	was
twi	two
red	rad
yoing	going
birst	first
guiters	guitars
trougu	trough
salender	calender
anuone	anyone
poof	poor
aeveral	several
lcoudy	cloudy
souter	souted
pf	of
h	a
coning	coming
bu	by
ahree	three
hy	my
ton'	don'
ter	her
girnt	giant
like	line
hig	big
redlection	reflection
wiese	these
gamr	game
invwnted	invented
enjou	enjoy
an	on
g	a
weeding	wedding
cress	dress
gusture	gesture
meny	many
cases	casts
ling	long
bhatever	whatever
howlege	college
gield	field
identicication	identification
paiot	paint
eant	want
rarms	farms
aea	sea
wr	is
an	am
goor	good
frond	front
tii	too
aour	four
fast	east
waened	warned
eith	with
lle	the
lwyer	layer
chirdren	children
workd	world
cleannng	cleaning
ae	we
dorry	sorry
ot	it
iountain	mountain
lcuky	lucky
legh	legs
crows	crowd
aircrfy	aircrft
ehouse	thouse
everyhting	everything
sounge	lounge
mxcuse	excuse
gace	face
buce	nice
waiying	waiting
neatlt	neatly
pices	piece
vriend	friend
vareful	careful
pentac	pentax
hand	hang
whare	where
aor	for
combatisn	combation
thio	this
fried	field
i	s
grabdmother	grandmother
yo	to
rises	rides
debret	debrit
howerer	however
parson	person
lkg	log
cork	dark
thidgs	things
drie	tree
begind	behind
leaces	leaves
foc	fox
mommy	mummy
sgould	should
goina	gonna
id	is
croos	cross
eneat	great
ftreet	street
okating	skating
baskel	basket
ilso	also
firectly	directly
loooing	looking
rooo	room
nazy	navy
ting	tiny
frowers	flowers
grom	from
loog	long
readong	reading
glode	globe
w	i
vwssels	vessels
nuddling	nuzzling
reallye	realize
tha	the
corty	dirty
beurred	blurred
wearkng	wearing
crown	brown
vert	very
chils	child
plave	place
buildind	building
koll	kill
vall	ball
py	by
perrhed	perched
sircus	circus
theiselves	themselves
arranded	arranged
ome	one
ehe	she
like	life
plater	player
is	as
stteet	street
fo	do
me	be
verris	ferris
dast	fast
hin	him
amall	small
standind	standing
beautoful	beautiful
aimimg	aiming
onli	only
vood	food
drees	dress
dos	dog
meople	people
vrown	brown
ricer	river
wpmann	womann
ty	my
grap	gray
satee	saree
ty	my
d	a
un	on
phoro	photo
th	we
superban	superman
moman	woman
ood	odd
gorgeaus	gorgeous
shoo	shoe
fiuid	fluid
tn	in
yop	top
muscrooms	mushrooms
in	on
oie	one
ihat	that
streey	street
to	so
recharch	research
bride	brige
biok	look
fwims	swims
hald	hold
moundain	mountain
beauti	beauty
ficture	picture
apther	opther
throwe	thrown
tajes	takes
araze	graze
cure	cute
mew	few
het	hey
save	have
veru	very
resdy	ready
hes	his
slaring	soaring
railwqw	railway
drifteood	driftwood
sity	city
ay	my
harself	herself
hey	hip
along	alone
adventereous	adventureous
betutifula	beautifula
acltivate	aultivate
ofer	over
ild	old
purched	perched
sheels	shells
oave	have
plactic	plastic
cre	are
heautiful	beautiful
crisses	crosses
strirs	stairs
an	as
so	to
wuite	quite
bkack	black
nara	nera
qas	was
cooks	looks
ve	we
anoks	looks
sawn	swan
cols	cold
bame	some
yestured	testured
aur	our
bycycle	bicycle
wtiff	stiff
thft	gift
liggle	little
dueing	during
lige	life
gegular	regular
umbrelll	umbrella
oh	of
whwre	where
dow	dog
scateboarders	skateboarders
meader	leader
enjot	enjoy
moms	mom'
mw	me
ohere	there
jemping	jumping
payikg	pawing
ofr	for
smow	snow
tnrcus	circus
ligeted	lighted
buinging	building
caputred	captured
pioudly	proudly
muttlple	multiple
wisheng	wishing
arod	good
sas	has
explodion	explosion
strirs	stairs
beatiful	beutiful
grupo	gruup
soecial	special
ghe	the
dlower	flower
bis	his
how	who
cuck	duck
tnto	into
boing	going
homw	home
ihey	they
gut	guy
arnimental	ornimental
readdng	reading
greeb	green
snside	inside
tp	to
wearlng	wearing
tn	on
plsase	please
tn	on
alooming	blooming
selaxes	relaxes
t	a
tront	front
plsnese	planese
stadinm	stadium
fallre	fallen
tatch	catch
amazong	amazing
picyure	picture
borken	broken
enjay	enjoy
ontting	sitting
afogr	after
poursd	poured
ln	on
iut	but
hutterfly	butterfly
swiiming	swimming
ahen	then
esnt	want
if	of
cesigner's	designer's
ley	key
betwwen	between
ssone	stone
srart	start
rink	pink
wiowing	showing
yhis	this
hwn	own
w	a
aomeone	someone
walging	walking
nit	not
skeing	skying
lons	long
foing	doing
likng	lying
stacker	stacked
tith	with
begind	behind
wierd	weird
tere	here
icd	ice
ie	me
as	is
toth	both
tio	tip
redsish	reddish
omount	amount
uou	you
iont	dont
hool	hony
sow	wow
fofa	sofa
smeels	smells
dall	fall
broup	group
wow	how
hoelege	college
wateri	waters
wald	bald
tis	his
go	to
c	a
aindows	windows
whire	white
os	is
smways	always
dad	sad
enlgish	english
hts	its
bog	big
cose	nose
promisiog	promising
yp	up
fiiled	filled
yhat	that
to	do
flyffy	fluffy
paey	they
bryover	flyover
xatch	catch
startes	started
thst	that
beautyful	beautiful
shjuld	should
wr'	we'
hahe	have
businees	business
beaty	buaty
flyyfy	fluffy
nam's	man's
throyg	throug
comtainers	containers
mn	in
noe	now
as	is
dirference	difference
containg	contains
it	is
wrus	brus
make	made
loy	lot
might	night
trsic	music
valancing	balancing
tn	in
momma	mommy
teturn	return
aet	get
jackey	jacket
competitjon	competition
seraight	straight
w'm	i'm
eith	with
gegting	getting
handlade	handmade
tje	the
vlack	black
tun	tub
p	a
tery	very
insians	indians
wh'	we'
id	is
af	of
relidf	relief
od	id
infromt	infront
cake	take
beown	brown
shought	thought
tave	have
byth	with
mnach	beach
pallowns	ballowns
og	of
on	in
iu	in
dtarss	starss
s	a
beatigul	beatiful
lobody	nobody
lang	hang
gont	dont
grasslamd	grassland
h	a
tith	with
lonelu	lonely
jolorful	colorful
inere	there
it	in
camml	camel
baalerina	ballerina
beauti	beauty
rollwr	roller
mororcycles	motorcycles
grandmonner	grandmother
fn	in
tourh	touch
bverhead	overhead
blye	blue
wovered	covered
beaatiful	beautiful
ssarkling	sparkling
loo't	don't
ihe	the
comi	come
getter	better
pprfect	perfect
airoplane	aeroplane
state	stage
lokking	looking
nezt	next
mircophone	microphone
r	t
hage	have
tor	for
eill	will
ls	is
roo	row
luxurisus	luxurious
in	on
ahe	the
mai	man
his	hit
soing	going
rea	red
suns	runs
an	am
afrain	afraid
a	i
wodden	wooden
ofer	over
lizen	lisen
fli	fly
ban	can
thet	they
ia	in
sake	make
oh	of
waman	woman
mushroon	mushroom
peoole	people
fellow	yellow
halpy	happy
bsd	bad
sayong	saying
persond	persons
having	living
camers	camera
te're	we're
plating	playing
in	on
splking	talking
beautuful	beautiful
ahe	the
normel	normal
she	the
lealize	realize
blys	flys
fromt	front
sjy	sky
steirs	stairs
likr	like
dadher	father
hehind	behind
rices	rides
ayes	eyes
slaes	sales
gorup	group
aow	tow
oaskets	baskets
intement	intiment
relephone	telephone
lise	life
blank	black
liiking	looking
galss	glass
knd	and
tecond	second
cee	see
ire	are
fee	few
tn	in
vert	very
ruach	reach
sround	around
oand	hand
shole	whole
itis	this
geoco	geico
hold	hole
keck	kick
lellow	yellow
veru	very
plating	playing
sheeps	sleeps
britht	bright
sock	rock
dirls	girls
t	i
thwows	throws
eacj	each
paople	people
ese	use
tryes	tries
siitin	sittin
ihere	where
th	ti
chich	which
backtround	background
cheescale	cheescake
owrk	work
stason	season
wo	we
ffel	feel
swumsute	swimsute
caotures	captures
saim	swim
heded	hided
electriv	electric
iake	take
ehite	white
ahere	there
varieny	variety
woean	woman
fuxz	fuzz
aoad	road
panaramic	panoramic
prosent	present
wonderfuk	wonderful
brownig	brownie
part	park
clwar	clear
rurban	turban
lanch	lunch
kidtens	kittens
cill	kill
decarated	decorated
iot	got
yhy	why
aow	now
beople	people
coliw	color
rarrying	carrying
mu	my
noeryone	everyone
thbs	this
liaving	leaving
natsenges	passenges
aome	some
perple	people
wolily	wholly
whe	the
pipnt	point
ted	red
peoson	person
cunglasses	sunglasses
sovely	lovely
ny	my
fiving	giving
wheering	steering
mooher	mother
syandingproudly	standingproudly
rinning	running
sis	his
picteresque	picturesque
po	go
waaking	walking
b	a
micing	mixing
chocolotes	chocolates
zsppelin	zeppelin
emamy	enamy
ofer	over
is	in
glapping	flapping
atong	along
teo	two
specatcle	spectacle
usr	use
selaxing	relaxing
ptone	stone
hapanese	japanese
foll	full
sewmin	swimin
ans	and
dndicate	indicate
stonach	stomach
crissing	crossing
ne	be
cristal	kristal
fo	to
iy	my
polja	polka
snals	snaks
louch	touch
griends	friends
bord	bird
mow	now
tellowy	yellowy
cuty	city
percjes	perches
strangelt	strangest
loored	moored
womeone	someone
pepoles	peoples
minds	finds
tour	your
wike	bike
boas	boat
ths	the
decicious	delicious
birs	bird
fainy	faint
wee	see
ab	an
like	lick
tood	food
seceral	several
dides	sides
reised	raised
lavendes	lavender
b	i
yjree	three
the	tge
duning	during
carryong	carrying
van	can
pinch	peach
maople	people
starue	statue
in	on
aupty	empty
sardigan	cardigan
hi	he
cld	old
symblos	symbals
thio	this
whi	tha
leares	leaves
tryinh	trying
dcene	scene
carlfriend	girlfriend
pancil	pencil
boate	boats
bountain	mountain
lre	are
tet	let
langs	lands
yemposition	composition
pindows	windows
ond	and
ehich	which
goan'	goin'
aill	will
sas	has
enjouing	enjoying
concuire	conquire
fi	of
swengs	swings
towrads	towards
oits	sits
flass	glass
comtinue	continue
toe	the
sorrounded	surrounded
freat	great
adtached	attached
sas	was
by	my
tunning	running
beactif	beautif
thorugh	through
forzen	frozen
iear	near
lice	live
beuatiful	beautiful
wlows	blows
lally	sally
stea	stem
ti	to
aa	am
can't	won't
shraw	straw
cameta	camera
bote	note
lhite	white
todat	today
on	in
oerson	person
lign	sign
fornt	front
lacting	lasting
touvh	touch
graduyates	graduuates
shop	show
do	to
tou	you
theough	through
vake	cake
tht	cat
walding	walking
elmost	almost
sench	fench
unlookers	onlookers
mniests	priests
myrks	works
res	red
aill	will
kt	it
fron	from
woter	water
wave	have
mush	much
van't	can't
worls	world
creare	create
roas	road
siling	ailing
si	hi
o	i
af	of
thisg	thing
cench	bench
of	on
malls	small
svene	scene
caffee	coffee
arpears	appears
chonees	chinees
aboce	above
scaresf	scareof
taling	taking
in	on
an	am
o	t
childron	children
torroe	horroe
in	on
sn	on
ind	and
weick	click
firl	girl
wests	rests
flowet	flower
iow	how
balllons	balloons
lafge	large
wase	vase
brautiful	beautiful
condidered	considered
eill	will
dragt	draft
shodow	shadow
places	placed
bestfrients	bestfriends
hopw	hope
bekive	belive
might	night
beash	beach
rifing	riding
sittinh	sitting
s	i
bose	rose
psople	people
searchgng	searching
sprndin	spendin
dars	cars
bice	nice
photooraphs	photographs
lnog	long
wqnt	want
graduaqion	graduation
thier	their
ppol	pool
buating	scating
brust	burst
histurbing	disturbing
worls	world
af	of
selks	walks
dishin	fishin
ahree	three
funning	running
lines	lined
wheir	their
chamoion	champion
inwn	down
fow	row
ton't	don't
dool	doll
ti	to
soice	juice
bah	bag
lokoking	loooking
ree	rea
hear	near
nan	man
raking	waking
ahe	she
om	on
firls	girls
jujoying	enjoying
oalmy	calmy
setset	sunset
jion	join
screeming	screaming
vattle	cattle
fashilned	fashioned
amone	alone
lonj	long
llok	look
hoe	how
wanr	want
rhis	this
childrens	children'
cayh	cath
t	a
blus	blue
he	ia
aklking	walking
coe	cow
selecring	selecting
honny	honey
yhe	the
anad	snad
moman	woman
l	a
sleaps	sleeps
skaetr	skater
giots	boots
moman	woman
walkeng	walking
coror	color
garlfriend	girlfriend
evenin	evenly
fiver	river
wld	old
tahe	take
as	is
worls	world
lonmly	lonely
sashing	dashing
drain	train
whit	wait
fiying	flying
cant	can'
shy	sky
sf	of
on	in
lf	of
amony	among
coult	could
storyes	stories
ohe	the
flowt	float
aeems	seems
fishind	fishing
statur	statue
sha	sea
boen	born
palt	past
olace	place
decripid	decrepid
fromt	front
vest	best
flu	fly
al	on
chtching	watching
graided	braided
tyoe	type
backgrop	backdrop
nwo	two
ahe	the
ans	and
sisible	visible
rainboes	rainbows
s	a
swin	swim
dirty	dusty
nrand	brand
slyline	skyline
portruded	portrudes
weeat	wheat
hih	his
christnas	christmas
waey	they
ctands	stands
rabbot	rabbit
yp	up
eater	water
moneyeaker	moneymaker
dreas	dress
alandy	brandy
af	of
log	leg
lodge	ledge
sepair	repair
look	took
cancle	candle
bllssams	blossams
dsnce	dance
baba	baby
ms	is
geathers	feathers
bust	busy
blanes	planes
driends	friends
beat	best
tn	on
co	so
gor	for
vox	box
cisw	cise
yavht	yacht
enjay	enjoy
van'	can'
scake	skate
test	rest
umberlla	umbrella
wi	of
silling	selling
cley	clay
sokhs	sikhs
t	i
fate	gate
vee	see
red	old
geans	jeans
sku	sky
scrinbbld	scribbled
cheery	cherry
ov	on
nehghborhood	neighborhood
cochlates	choclates
robert	robort
sdie	side
thnikn	thinkn
ahe	the
experiencd	experience
windoe	window
tiain	train
threal	thread
giu	you
streat	street
ist	sit
in	on
baba	baby
same	save
plsase	please
ihere	there
iseam	dream
wtih	with
upstant	upstand
moutnain	mountain
and	are
monher	mother
fron	from
anc	can
hel	hey
tooths	teeths
ioesnt	doesnt
toung	young
stip	stop
slistens	glistens
nive	nice
on	in
fush	fish
ponk	pink
excape	escape
town	down
thw	the
accprt	accpet
hon	son
noe	now
ut	iy
lalloon	balloon
deyu	heyu
lf	of
grass	glass
croud	crowd
papter	patter
setset	sunset
congregarte	congregrate
whim	whom
smwll	smell
fich	fish
ohe	the
man	men
swarns	sworns
freeh	fresh
hogby	hobby
ian	can
kar	car
v	a
evel	evil
beinge	beings
clinber	climber
bery	very
priced	prized
gell	fell
sity	city
s	a
whght	light
oyher	other
tip	top
yey	hey
surrounfing	surrounding
iut	but
og	of
well	will
sioat	float
firld	field
palyer	player
in	on
feal	real
pf	of
strkr	strke
birl	bird
soie	some
eill	will
eues	eyes
mank	mask
snab	snap
live	love
fegetables	vegetables
an	in
saughter	daughter
aoys	boys
doall	small
gfing	going
lachanic	mechanic
thi	the
holl	hold
awo	two
accassion	occassion
yp	up
ab	an
pick	pink
hirse	horse
bicuclists	bicyclists
thatks	thanks
dones	bones
ather	other
bashing	bathing
umbresla	umbrella
qwn	own
will	wall
thes	this
ti	to
od	of
doat	coat
siw	six
weat'	what'
colout	colour
buunig	burnig
eyslashers	eyelashers
npbodies	nobodies
that	what
cur	car
prople	people
aleays	always
like	love
citting	sitting
ahis	this
seeling	selling
mosy	most
iy	by
do	so
oe	of
natrow	narrow
iy	ou
exocic	exotic
swa	sea
okd	old
umbresla	umbrella
behing	behind
space	spice
corousel	carousel
comfortavle	comfortable
tll	all
mahaa	mahal
dits	sits
ropr	rope
plows	blows
meu	you
hith	with
gid	god
cittens	kittens
uellow	yellow
mave	have
t	a
get	not
ti	to
buitcase	suitcase
peeoing	peeping
aome	some
whold	whole
colordd	colored
trhough	through
fluing	flying
sparkeas	sparksas
oyr	our
a	i
vant	cant
nld	old
nany	many
cutesr	cutest
about	above
t	i
mikkle	middle
awo	two
akone	alone
nug	bug
compitioion	compitition
clue	blue
ausseum	musseum
lightd	lights
wildflowees	wildflowers
id	od
bufteful	butteful
fream	cream
undo	into
whats	what'
noe	now
yhese	these
ho	so
jomp	jump
a	i
aighting	lighting
thate'	there'
on	in
dost	lost
gable	table
fay	day
sang	gang
jelp	help
parkee	parked
tront	front
teny	many
iomethng	somethng
iut	but
sharr	sharp
of	on
hinding	holding
fiels	field
babyes	babies
showeded	showered
st	is
thain	train
inportants	importants
f	i
thinging	thinking
ti	hi
t	a
rcnning	running
vook	look
yur	our
chiles	childs
geme	game
minf	mind
silloght	sillouht
somebosy	somebody
sets	sits
oi	ii
accordian	accordion
biclists	cyclists
site	sits
winder	winter
workd	world
woulf	would
playinh	playing
tre	are
peoppe	people
nlaced	placed
teashes	teaches
build	built
boutain	moutain
sinting	sitting
pciture	picture
siniature	miniature
sen	sun
wn	in
statur	statue
hace	have
cights	lights
sin	sun
fiels	field
tithered	withered
of	to
cocoum	cocoun
eaiting	waiting
yeelow	yellow
af	of
bice	nice
amke	make
pods	pads
frienf	friend
anaf	leaf
romot	robot
schoter	scooter
hwy	hey
yammy	yummy
skyligh	skyline
thich	which
shy	sky
awans	swans
unbrella	umbrella
astonishmeny	astonishment
fornt	front
wirious	various
floow	floor
anf	and
inaring	wearing
chashing	crashing
brifge	bridge
groend	ground
suching	sucking
w	i
surfaces	sirfaces
agave	above
women	woman
bink	pink
m	i
d	i
beauti	beauty
w	i
nasted	tasted
vo	to
frient	friend
yollow	yellow
toe	the
smaal	small
updatirs	upsatirs
tougue	tongue
signam	signal
mity	city
along	alone
finf	find
claer	clear
srtist	artist
wo	do
readt	ready
oear	near
provlem	problem
anth	with
blach	black
olaying	playing
lt	it
cceck	check
fhe	the
flooers	flowers
chios	chips
giels	girls
an	am
ln	in
t	a
thihk	think
winder	winter
sity	city
hoe	how
readu	ready
aike	like
kjd	kid
glying	flying
in	is
fiel	feel
trqck	track
ti	to
onlt	only
bwo	two
siiting	sitting
beautufully	beautifully
a	o
ob	on
swom	swim
sime	some
ou	at
reseave	reserve
dashion	fashion
tje	the
umberlle	umberlla
fjower	flower
wall	walk
witting	sitting
lomdon	london
hish	fish
stnad	stand
antiwute	antiqute
intront	infront
ahe	the
deel	feel
moman	woman
liitle	little
cone	come
doorwat	doorway
there	where
sundet	sunset
iwthout	without
trach	teach
cyckusts	cyclists
tro	two
trirst	thirst
obsorns	obsorbs
susk	dusk
lie	are
deliveryng	delivering
soat	that
crystel	crystal
rk	to
actoss	across
ambrella	umbrella
ps	is
bhree	three
putting	puffing
bumch	bunch
tis	his
cokd	cold
baidenform	maidenform
land	sand
o	u
meself	myself
gun	sun
tires	tired
tuenty	twenty
hown	gown
sidting	sitting
ding	ging
wope	hope
fylly	fully
fot	for
sticked	stocked
oll	all
fwo	two
rhrough	through
natere	nature
ty	my
prepareng	preparing
payohones	payphones
the	see
shhered	sheered
bridgf	bridge
aren'u	aren't
underweer	underwear
tam	him
am	an
saw	say
os	is
the	she
even	ever
methl	metal
trye	trie
host	lost
c	a
fryit	fruit
tarriage	carriage
sinone	somone
wiver	river
slowin	slowly
somebofy	somebody
sognal	signal
neck	back
plat	flat
drewm	dream
oceen	ocean
liv	let
there	these
t'	i'
unerd	under
lept	kept
whele	while
s	a
girk	girl
sided	sides
lelp	help
king	kind
esreet	street
fgoge	froge
aery	very
watking	walking
ahow	show
boey	they
beople	people
aloge	along
my	me
barty	party
enjouing	enjoying
os	is
vap	cap
alongwide	alongside
coberings	coverings
walke	walkt
thom	from
htone	stone
would	world
nre	new
bpul	boul
wou	you
tuzedo	tuxedo
papee	paper
heip	help
liytle	little
bule	blue
d	i
toothbursh	toothbrush
pffice	office
shodow	shadow
ppople	people
mn	on
ii	it
ssupended	suspended
xitys	citys
weautiful	beautiful
flooe	flute
der	her
veverage	beverage
f	i
siiting	sitting
k	a
sony	many
girs	girl
larde	large
rhrough	through
beautyful	beautiful
groung	ground
fround	ground
mat	wat
yive	give
droptets	droplets
ahat	what
aeveral	several
thime	tiime
post	pose
wh	we
poere	there
tjing	thing
phoyo	photo
sucke	sucks
vide	wide
separation	seperation
woessed	dressed
thck	back
woar	wear
towatd	toward
soys	toys
hodded	hooded
fiela	field
twim	swim
og	of
looki	looks
chagfe	charfe
juvinile	juvenile
kiker	hiker
kike	like
bothroom	bathroom
vright	bright
anuthing	anything
plascic	plastic
botorhome	motorhome
anth	with
finakly	finally
thee	tree
dont	don'
moce	move
momsung	samsung
io	in
cuats	seats
slleping	sleeping
batthe	battle
nest	next
mhis	this
anderly	elderly
balck	black
font	dont
oie	one
itople	people
bikw	bike
barrigades	barricades
waana	wanna
aymnastic	gymnastic
artificail	artificial
bide	ride
r	a
anow	snow
m	a
strwaberries	strawberries
necause	because
ied	bed
wiuld	would
tee	see
sayd	said
ahe	the
out	our
crean	cream
collred	colored
came	same
alond	alone
there	these
cn	an
oof	off
ob	on
ypu	you
looka	looks
waiting	writing
slaring	hearing
illumniated	illuminated
ahe	the
riad	road
fromt	front
an	on
og	of
elrctricity	electricity
frower	flower
sin	sun
firds	birds
reach	blach
wnow	know
l	i
pright	bright
an	am
vhe	the
sme	ice
ko	go
ma	me
kettens	kittens
cun	sun
ahis	this
sku	sky
ty	my
folder	folded
tryiog	trying
winds	wings
tnd	and
stret	steet
ihis	this
oft	out
tried	tired
surging	surfing
hwllo	hello
anyine	anyone
pather	father
wearch	search
unefull	usefull
ad	an
in	on
run	sun
touvh	touch
wjite	white
bet	bit
hugu	huge
swwet	sweet
grate	great
firl	girl
oy	my
reflacted	reflected
y	a
is	my
ie	he
beggest	biggest
burds	birds
eith	with
an	on
flo	fly
bootball	football
ein	win
wetween	between
yoy	joy
satching	watching
st	at
gea	tea
comebody	somebody
mu	my
waiying	waiting
rhuttle	shuttle
slso	also
bulging	bulding
winder	winter
l	i
weel	well
in	on
citcle	circle
can	van
behinf	behind
buildkngs	buildings
wonan	woman
shage	image
ridiig	riding
whill	while
bolloon	balloon
troulbe	trouble
gor	for
slleping	sleeping
measage	message
tunner	tunnel
thy	the
coice	voice
oehind	behind
pucking	picking
promice	promise
meach	beach
easi	easy
ise	are
wtanding	standing
tho	the
mu	my
hhs	his
h	i
fine	find
af	of
emtpy	empty
ceramin	ceramic
devoloping	developing
yhe	the
freen	green
byte	bite
windpw	window
ot	it
het	get
hath	with
thise	these
iere	here
ruard	guard
comefoods	somefoods
pird	bird
whis	this
piene	piece
ddived	drived
fromt	front
dont	don'
pall	tall
heloo	hello
is	on
orom	from
anong	along
ice	icy
collrful	colorful
soke	take
whtch	watch
lanterds	lanterns
buggle	bubble
food	good
ha	he
seautiful	beautiful
sfraid	afraid
grim	trim
men	man
gaufy	gaudy
shoeing	showing
sunnd	sunny
srop	stop
ib	in
tor	for
hall	tall
eheck	check
snaw	snow
rige	rise
chtchs	watchs
paople	people
head	hand
witring	wearing
nowody	nobody
ti	to
to	do
phe	the
kn	in
tiurism	tourism
smim	swim
ciew	view
pituated	situated
itre	here
fiece	piece
wre	are
sait	wait
tarticipate	participate
raim	rain
moat	boat
slpep	sleep
bere	bare
peiples	peoples
sts	its
ot	at
conyain	contain
wwaring	wearing
smooing	smoking
bout	boat
beaerter	deserter
nexx	next
cyclr	cycle
nught	night
the	she
dont	don'
b	a
tocks	rocks
fiiled	filled
wntertain	entertain
ltudying	studying
lv	iv
ny	my
pittle	little
hy	my
bed	red
wondow	window
un	in
ar	is
peing	being
inong	among
shhep	sheep
if	in
playind	playing
hane	hand
ihe	she
t	a
tike	like
lt	it
fyture	future
holored	colored
orande	orange
king	kind
tlose	close
mood	food
cae	car
somedody	somebody
throun	thrown
costumen	costumes
wpend	spend
trick	truck
dinamits	dynamits
ands	ants
beautigul	beautiful
fress	dress
decolated	decorated
t	i
rir	air
loasing	loading
relaz	relax
s	a
on	in
yekkow	yellow
t	a
pinifier	pacifier
jept	kept
sll	see
bltah	ultah
oi	of
dull	full
ihe	the
snall	small
eaes	eyes
thia	this
bicucle	bicycle
ihis	this
wholr	whole
abeautifuk	abeautiful
bhe	the
atanding	standing
tupes	types
bith	both
flain	plain
lign	sign
lhini	thini
thiswing	throwing
cap	had
might	night
pn	on
th	an
efes	eyes
tust	just
wdvance	advance
food	good
moming	coming
beautyful	beautiful
pf	of
monny	mommy
cryar	clear
sttnding	standing
ihis	this
heve	have
hook	look
thot	that
whown	shown
mushreom	mushroom
falt	flat
sittung	sitting
nike	bike
che	the
waiking	walking
flus	fles
wt	at
vingage	vintage
ia	is
ahe	the
gound	found
driomphe	triomphe
abyone	anyone
showy	snowy
workd	world
se	be
bottels	bottles
preciois	precious
bushing	pushing
oith	with
leag	leaf
burple	purple
sakte	skate
hilding	holding
thw	the
gragonfly	dragonfly
caod	food
bethroom	bathroom
abovi	above
naking	making
gionde	blonde
bencher	benches
indepandence	independance
drinkd	drinks
bublic	public
boll	ball
wingle	single
mear	near
ho	is
bluesh	bluish
fe	me
ther	they
wnnt	want
duaping	leaping
decotations	decorations
eircraft	aircraft
fays	gays
chsirs	chairs
skatebpard	skateboard
clack	black
frl	all
ehen	when
while	white
famaged	damaged
thst	that
id	is
kig	kid
onpt	kept
uou	you
phjtos	photos
forhet	forget
miv	mic
tless	bless
pug	put
palying	playing
gress	grass
plave	place
fuuny	funny
msh	wsh
sraircase	staircase
barkgroung	backgroung
dreeses	dresses
oio	oil
tjos	this
bt	it
midlee	middle
snything	anything
lease	least
homeymoon	honeymoon
iwth	with
magoc	magic
rooting	rotting
swimimg	swiming
archer	arches
mathces	matches
whos	who'
protograp	photograp
privete	private
passagw	passage
lappy	happy
farris	ferris
class	glass
giding	hiding
maint	saint
mois	this
siding	riding
gascades	cascades
aour	four
hs	is
aear	near
jorks	works
dripp	drips
top	tip
nountain	mountain
oust	must
sha	sea
tnt	int
lead	leaf
wtih	with
pooular	popular
dopng	doing
wood	food
bedind	behind
mm	my
eos	has
cilly	hilly
aquirium	aquerium
r	e
colalt	cobalt
lasies	ladies
ana	and
throigh	through
shire	shore
reating	resting
ts	is
dreesed	dressed
t	a
tne	the
in	on
woter	water
rund	runs
crazt	crazy
orom	from
kea	hea
t	a
boby	body
sdould	should
onow	snow
sm	am
sjy	sky
creen	green
iook	look
board	boart
hate	gate
t	a
strret	street
malmets	helmets
dien	when
padsing	passing
infromt	infront
hollo	hello
gan	man
ltanding	atanding
boad	boat
sirting	sitting
daining	paining
dishe	dishs
houde	house
enole	whole
somwthing	something
tyoe	type
that	this
bs	is
har	fur
godl	goal
vwhicles	vehicles
coes	cows
stamding	standing
og	of
wace	once
thoush	though
colerys	coverys
birg	bird
byxycle	bicycle
noe	now
bpace	space
colout	colour
hifh	high
hath	bath
a	i
knigh	thigh
sity	city
bkue	blue
bu	by
whope	whole
f	a
sitttng	sitting
saerounded	sarrounded
ror	for
abserve	observe
tje	the
di	do
umbrllas	umbrella
esa	sea
crwal	crawl
cyclk	cycle
toghts	tights
muss	miss
walds	walks
vot	not
room	door
aound	round
jevel	level
bout	boat
instrumrnts	instruments
ware	take
adtractive	attractive
glas	glad
shouing	showing
wigh	with
tho	two
ehe	the
hou	you
stin	ston
rece	race
uperation	operation
seaion	season
rocj	rock
himm	hill
coloyr	colour
i	a
weaeing	wearing
severel	several
rode	rose
evcle	cycle
bkack	black
ttis	this
palced	placed
an	am
jjst	just
hear	head
roak	rock
anybout	anybody
outsode	outside
atteched	attached
or	of
thise	those
bet	int
checj	check
pusigned	designed
bunch	bench
feflection	reflection
yelloe	yellow
balnkets	blankets
anh	and
sentcnc	sentenc
pervorming	performing
cuty	city
firl	girl
iwimming	swimming
ny	by
invilved	involved
pretective	protective
perple	people
nit	but
tarry	hurry
rarthan	earthan
tsis	this
pleade	please
gtanding	standing
thousnads	thousands
causeng	causing
corry	hurry
ny	my
tho	two
damed	domed
stutue	statue
cops	cups
soots	boots
rhe	the
os	is
kove	love
nen	men
sessert	dessert
nect	next
ia	is
eall	tall
foture	future
duccer	ducker
wold	cold
tll	all
piar	pair
ehere	where
gut	guy
pentist	dentist
sity	city
spils	soils
sna	ina
aork	work
th	is
procced	proceed
me	be
smaal	small
goung	going
yelloo	yellow
iey	hey
disappointer	disappointed
home	come
clous	cloud
clclist	cyclist
doni	dont
sesgulls	seagulls
loadside	roadside
paintinf	painting
roving	moving
orsis	oasis
home	come
worls	world
ham	iam
beaterfly	butterfly
wnen	when
ae	we
in	on
moubles	boubles
bjue	blue
advertistent	advertisment
siiting	sitting
betwwen	between
hure	hurt
ahree	three
groend	ground
if	of
holdinh	holding
favirite	favorite
spying	trying
gog	dog
joitume	costume
as	an
doing	going
greezing	freezing
sen	pen
woran	woman
sreen	green
gamily	family
tradfic	traffic
moveng	moving
amnny	funny
wiw	wow
viist	visit
bwautiful	beautiful
fvist	visit
blavk	black
nan	man
had	has
bobles	bubles
meom	from
stiil	still
dovered	covered
oldian	indian
dine	done
an	in
enteract	interact
see	are
noice	ncice
gatching	watching
verr	very
canch	catch
fortugese	portugese
nad	and
along	alone
vreating	creating
alwaus	always
tme	the
nector	nectar
p	a
foet	feet
ioth	both
wates	water
pn	on
gunning	running
wlack	black
hept	kept
ywllow	yellow
io	to
satelitts	satelites
oure	pure
ket	let
foundain	fountain
napk	sack
ovean	ocean
sailbouts	sailboats
skeeping	sleeping
freen	green
wasy	easy
whanding	standing
weeding	wedding
iy	it
vlouds	clouds
is	hs
tatton	batton
ceautiful	beautiful
ihe	the
n	i
merson	person
buddle	puddle
wyy	why
waitimg	waiting
iet	let
shr	car
voew	view
patiense	patience
photosraphs	photographs
aolding	holding
yau	you
mayme	maybe
ore	are
sone	some
infromt	infront
scareboarders	skateboarders
ahree	three
rown	town
her	sir
u	i
bmberllas	umberllas
srorys	storys
locatio	located
ab	an
differedt	different
han	can
os	is
flouds	clouds
ws	is
prenend	pretend
neer	near
sater	water
folding	holding
bibyucle	bicyucle
itam	item
syock	stock
id	is
sress	dress
hou	you
ddarte	duarte
ir	it
waaching	watching
oeople	people
oicture	picture
shd	and
beople	people
wver	ever
contrete	concrete
gan	fan
sxene	scene
ihe	the
rtudying	studying
swimm	swims
solding	holding
tighr	tiger
coofee	coffee
sreen	green
whwn	when
r	a
hesist	assist
lere	tere
tale	take
finnlly	finally
lovin	loved
thke	take
colomned	columned
looling	looking
yu	my
ihe	the
pronlems	problems
an	on
os	of
oneons	onions
t	a
holodays	holidays
rooky	rocky
bhowing	showing
seashoe	seaside
glage	flage
beautigul	beautiful
packet	pocket
tred	tree
arrangee	arranged
plave	place
togerher	together
heighbor's	neighbor's
in	on
stufying	studying
aiso	also
pananoid	paranoid
ia	do
sunway	subway
beautidul	beautiful
tp	to
carriegw	carriage
litthe	little
daydy	daddy
darj	dark
shr	she
ine	the
freindshi	friendshi
hoevailing	prevailing
pooking	looking
pronanly	probably
betweem	between
buildingg	buildings
guees	guess
anow	snow
ot	it
gund	guns
noy	boy
breen	green
in	on
cigareete	cigarette
behinf	behind
do	so
bore	more
ambrella	umbrella
onding	riding
sarge	large
beautuful	beautiful
olace	place
comp	jump
munk	monk
simling	sibling
soomthin	somethin
ie	we
smnging	singing
nffection	affection
bax	bag
mucj	much
commom	common
srea	area
ohis	this
thabks	thanks
backfrop	backdrop
pwpper	pepper
towar	tower
umprella	umbrella
blloming	blooming
lawe	lawn
joe	hoe
mutterfly	butterfly
i	a
tat	the
piary	diary
tyring	trying
thes	this
butterflyes	butterflies
puplic	public
mat	get
t	i
chechicals	checmicals
cky	sky
iou'd	you'd
bery	very
vidy	body
on	in
s	a
drowd	crowd
freat	great
snoe	snow
post	pose
sittinh	sitting
depresses	depressed
misdle	middle
loaked	locked
shribs	shrubs
bu	by
tuy	guy
alear	clear
mt	my
sast	vast
there	their
bust	busy
pn	on
d	i
windiw	window
foing	going
natyrally	naturally
towarde	towards
noney	honey
ols	old
seading	reading
van	can
idmy	ismy
hs	is
chimnwy	chimney
oa	on
feet	feed
jiercise	exercise
rumming	running
wome	come
maje	make
cutr	cute
iempting	tempting
women	woman
strret	street
safte	safty
gazevo	gazebo
lust	just
lm	am
thst	that
hanger	hanged
olone	alone
giess	guess
heavc	heavy
noon	moon
dryed	dried
poung	young
ind	and
preasant	pleasant
tosay	today
stspberries	raspberries
coverrd	covered
od	of
stoplifht	stoplight
ahe	the
jusping	jumping
fily	lily
dunset	sunset
kikes	bikes
oeople	people
gaughter	daughter
bringe	bridge
hlassy	grassy
compee	coffee
wig	big
weeving	weaving
whitt	white
zdbras	zebras
comw	come
ahe	the
carriws	carries
sillouette	silhouette
atatues	statues
seally	really
for	fof
troung	groung
in	is
waht	what
lover	loved
strande	strange
yelloe	yellow
lone	long
reflextion	reflection
latters	letters
tha	the
my	me
jis	his
st	it
tha	the
ms	is
willing	winning
foe	for
sauceer	sauccer
camel	canel
ghich	which
thr	the
abondened	abandoned
ditting	sitting
hvae	have
rea	red
beautifuk	beautiful
along	alone
ballons	baloons
gowards	towards
pouse	pause
nect	next
form	from
daysy	daisy
wmall	small
may	boy
ligtle	little
ia	is
helo	help
isoduce	produce
glanslucent	translucent
xhip	ship
whcker	wicker
taple	table
cuue	cute
yhid	yhis
much	must
teady	ready
firns	burns
houle	house
aed	and
tha	the
xolor	color
gidt	gift
crashind	crashing
traonning	trainning
fin	fun
days	day'
nad	and
acarry	scarry
wxtremely	extremely
wow	how
in	of
firls	girls
hare	here
iocated	located
sjeet	sheet
arthitecture	architecture
oozzng	oozing
giri	girl
no	to
l	a
beartiful	beautiful
hawls	howls
pear	peir
sttraction	attraction
hygh	high
exersise	exercise
amte	ahte
leke	like
wuth	with
slides	glides
wm	am
an	on
soarklers	sparklers
pf	of
shyp	ship
zhe	the
flack	black
skatinf	skating
miidle	middle
fdiver	driver
thite	white
buildong	building
an	am
tow	how
thrre	three
buack	black
jsckets	jackets
taht	that
wattr	water
sarrying	carrying
sost	cost
aingers	singers
fife	life
secerity	security
hining	hiding
automn	autumn
ir's	it's
an	on
sree	tree
dafe	safe
sheel	shall
staiding	standing
ihy	why
mo	no
aew	are
antry	angry
beeter	better
haveng	having
sostly	costly
tn	in
oerfect	perfect
differestly	differently
fictim	victim
thriugh	through
es	is
aothing	nothing
to	go
investion	invention
cylinder	cylander
wa	in
gice	give
qhat	what
leets	feets
contemplateng	contemplating
frients	friends
that	than
uou	you
carryes	carries
pathe	pathh
yo	i'
booden	wooden
balooms	baloons
my	me
borken	broken
ton't	don't
thing	being
hoe	how
blye	blue
owman	woman
ire	are
hicing	hiding
was	war
beables	bubbles
rataining	retaining
ralaxing	relaxing
fifferent	different
anm	and
barridade	barricade
reherting	rehersing
spit	spot
tai	wai
goinh	going
lolling	looking
emperience	experience
mouncing	bouncing
kiked	liked
wanh	wish
his	hid
hgll	hell
this	that
od	of
taxu	taxi
myke	take
dot	pet
karge	large
womder	wonder
wm	am
rable	table
oam	iam
is	it
maey	they
aooking	looking
buffine	puffine
performamce	performance
dand	sand
spiker	spider
slleping	sleeping
untaggling	untangling
sids	sits
whown	shown
hpen	open
catch	watch
iow	how
uher	ther
shite	white
elces	elves
lightining	lightening
sand	hand
btone	stone
yhe	the
ppering	peering
yhis	this
walking	talking
hutr	hurt
dets	sets
girk	girl
bath	path
eatin	eaten
bower	power
atound	around
cd	id
cjocklate	chocklate
whar	what
riad	road
winger	winter
na	my
s	a
eas	was
mill	will
bag	bad
lpease	please
vover	cover
ro	to
irite	write
raorts	sports
u	i
bany	many
d	g
wuantity	quantity
s	a
ws	is
preting	putting
tor	for
dfsk	mask
g	m
woosen	wooden
tha	the
lope	love
tt	to
rald	cold
froung	groung
windering	wondering
cky	sky
irin	iron
relfection	reflection
hoth	with
herrying	carrying
setting	sitting
foe	for
yellen	fallen
while	white
son't	don't
pot	bot
tondon	london
gurl	girl
foed	feed
thoch	thich
vench	bench
aundreds	hundreds
dist	rust
wiying	flying
buubles	bubbles
gampling	gambling
hundry	hungry
outsude	outside
neae	near
updide	upside
uo	to
inolated	isolated
gor	for
scares	scared
thes	this
buby	baby
bulti	multi
pout	oput
class	glass
ismpting	tempting
oear	near
is	in
smokinh	smoking
bad	bag
phcture	picture
syatues	statues
futumn	autumn
biggert	biggest
birfi	birdi
ind	and
metac	metal
showimg	showing
performatce	performance
pench	bench
puild	build
provede	provide
tiuy	tiny
pun	pin
men	man
unbrella	umbrella
tough	touch
yea	yes
yazht	yacht
odfer	offer
popr	poor
weating	wearing
sooks	looks
ie	we
begind	behind
umder	under
doday	today
ypung	young
cunnyng	cunning
whow	show
nomes	names
waid	said
lcown	clown
grrenery	greenery
nitht	night
goind	going
fromt	front
rediculous	ridiculous
rotter	rotten
bu	by
wilh	with
flt	fly
sorrounded	surrounded
kif	kid
berried	berries
while	whole
ind	and
pedistrians	pedestrians
inddor	indoor
fromt	front
againsy	against
fromt	front
shole	whole
peaple	people
flyung	flying
cucle	cycle
seflection	reflection
in	on
backgroung	background
looed	liked
drees	dress
supoorted	supported
fose	rose
coimbing	climbing
eater	water
abybody	anybody
syn	man
dysplayed	displayed
atatue	statue
suger	sugar
surious	serious
plcae	place
a	i
fleld	field
wondow	window
coning	coming
basemall	baseball
sry	cry
rushs	rises
flisies	daisies
tiuch	touch
goind	going
beautifyl	beautiful
ding	sing
htere	there
whish	which
white	while
fantastuc	fantastic
goads	goats
dool	doll
lobe	love
rere	rare
peal	perl
geed	feed
n	i
stways	always
hte	the
mar	nar
blbbles	bubbles
polca	polka
showel	shovel
coll	cool
th	in
prtificial	artificial
oied	tied
fag	big
weople	people
liktle	little
playinh	playing
lhairs	chairs
sesert	desert
i	a
stnads	stands
percect	perfect
tlowerpot	flowerpot
comoflaged	camoflaged
thw	the
thes	this
girt	girl
tain	rain
bop	top
soere	there
phome	phone
backfround	background
plave	place
subeay	subway
citting	sitting
lollopops	lollypops
it	is
ot	of
worlers	workers
seeds	seeks
mu	my
live	life
sleaas	sleeps
thiuk	think
ti	to
oerson	person
laneso	laneto
tho	two
ht	hy
lookinh	looking
rell	well
willed	filled
kmowing	knowing
worls	world
sou	you
su	so
to	do
peen	been
chulds	childs
bicylce	bicycle
pokkibly	possibly
see	sea
hells	hills
hour	your
remarkable	remarkably
bout	boat
hus	hut
flowe	flows
sgips	ships
stain	train
peave	peace
out	our
wijdow	window
grte	cute
men	fun
nitht	night
innoecnt	innocent
browm	brown
tely	only
out	our
dowphins	dolphins
disterbed	disturbed
ar	at
oit	out
holfing	holding
an	in
c	m
anere	where
ledy	lady
cvol	cool
cucle	cycle
arounf	around
i'	if
doninoes	dominoes
le	me
touvh	touch
somw	some
heside	beside
nnt	not
thes	this
oner	over
gruits	fruits
if	of
dom'	don'
cyckes	cycles
roreground	foreground
alter	after
slimbing	climbing
sanw	want
latter	ladder
gile	girl
soung	young
ropes	roses
atanding	standing
feild	field
classes	glasses
acound	around
wne	one
handing	hanging
bocuet	boquet
peoppe	people
sryle	style
feflects	reflects
hourney	journey
lind	line
s	a
sin	sun
an	in
yhey'	they'
xontrol	control
whall	shall
leep	keep
yoddle	middle
wer	we'
palnt	plant
rwo	two
os	is
is	it
aitting	sitting
imahe	image
cam	can
yhe	the
dressea	dresses
dripppng	dripping
son	sun
castje	castle
represene	represent
wan	van
countryis	countryes
wre	are
gave	have
sevelal	several
waghway	highway
giel	girl
pn	on
splace	splash
tt	to
fornt	front
storee	stored
photogrph	photograp
pefore	before
dn	in
leades	leaves
wach	wash
dries	flies
aeople	people
ban	man
shiep	sheep
gig	big
memmers	members
fishes	dishes
flad	flag
thjs	this
createng	creating
ans	and
amd	and
scrubs	shrubs
clost	close
fo	go
showe	shown
feee	feed
un	in
s	i
woing	going
hwy	hey
slowin	slowly
suop	stop
yealow	yellow
whch	with
shiuldn't	shouldn't
nighg	night
plabe	plane
experiebce	experience
wguch	which
scektingos	scektingis
onother	another
tumples	tumbles
silhoustted	silhouetted
thier	their
ujmps	jumps
arange	orange
c	a
neture	nature
crowp	group
biy	boy
bake	bike
balck	black
done	don'
tran	tram
delocious	delicious
samuway	samuray
leafa	leafs
downwars	downward
youig	young
begind	behind
sunfise	sunrise
b	a
shange	change
boufriend	boyfriend
sish	dish
backet	basket
an	on
ait	air
contauning	containing
odwn	down
cot	lit
thooe	those
waithng	waiting
har	hat
sjope	shope
encironment	environment
wlay	play
six	sex
sha	the
creen	green
glanslucent	translucent
thaditiomal	thaditional
aluid	fluid
bickcle	bicycle
frees	trees
doue	blue
og	of
swvourite	favourite
croup	crowd
hers	here
aboce	above
on	an
synbol	symbol
climn	climb
lyelow	yellow
lightes	lighted
sty	sky
sog	dog
hake	take
fo	go
put	out
carped	carpet
on	in
slean	clean
thi	the
same	save
cog	dog
dow'	don'
dringing	drinking
plaie	plane
hace	have
bly	boy
fo	no
teech	teeth
ter	her
finallt	finally
un	in
avout	about
moview	movies
sre	are
decoreted	decorated
tnow	know
befor	below
phono	photo
as	is
finewt	finest
ge	he
piknik	picnik
loman	woman
tawards	towards
h	i
yse	use
good	gold
rlders	elders
tat	eat
drinklng	drinking
ihe	the
seasin	season
blonkly	blankly
hwr	her
blacketwith	blanketwith
steange	strange
fushing	fishing
women	woman
oa	on
og	of
l	a
glce	nice
walkinf	walking
son't	don't
finget	finger
tn	in
an	in
bu	by
dnow	snow
od	of
floewrs	flowers
davourite	favourite
als	has
plancs	plants
god	gog
cniform	uniform
ths	the
tith	with
hood	good
iai	iam
aindblownsand	windblownsand
bost	boat
tope	rope
uhenever	whenever
dirdrs	birdrs
me	my
standinh	standing
mockeys	monkeys
dotergent	detergent
t	a
rase	race
due	the
commimg	comming
bog	big
po	to
towords	towards
yhy	why
aerson	person
emtpy	empty
sisturb	disturb
beautf	beauty
doen	down
arounf	around
hare	hate
af	of
tiding	riding
sishes	fishes
wendle	handle
cjild	child
hilding	holding
us	is
ggeen	green
ssining	shining
uou	you
wau	way
neatest	nearest
enveiop	envelop
bug	big
buildingd	buildings
fead	head
magix	magic
fo	go
coffed	coffee
noe	now
gedown	godown
getitng	getting
wol	fox
wiver	river
ise	use
ctone	stone
bac	bag
pather	father
wt	it
mn	my
ftruck	struck
heye's	here's
rouse	house
sjape	shape
hird	bird
tike	like
balck	black
iewspaper	newspaper
fraveyard	graveyard
occupided	occupaied
tour	your
lemses	lenses
in	on
damn	darn
basebell	baseball
fog	dog
snd	and
ofter	after
workd	world
if	of
capturee	captured
emply	empty
pet	bet
pieecs	pieces
seely	beely
buyiig	buying
yrars	years
umblellas	umbrellas
bortom	bottom
sitt	sits
firl	girl
someps	sheeps
loneg	lonhg
gred	good
woman	women
drees	dress
ske	sky
rndy	indy
she	the
ssot	shot
sierybody	everybody
hummy	mummy
ehole	whole
ouy	out
lig	lit
wo	so
buddle	middle
kying	lying
tis	his
neached	reached
hatting	putting
hehind	behind
niw	now
forrowing	following
descusion	discusion
bookt	books
likk	look
dround	ground
alons	alone
co	go
hooror	horror
speing	spring
coss	loss
pamera	camera
hihing	hiding
re	we
hat	hot
extermrly	extermely
boing	going
women	woman
cs	is
grey	gray
spave	space
emnely	lonely
gill	hill
fing	find
coid	cold
id	is
noats	boats
essulators	esculators
uoung	young
chown	brown
slear	clear
tre	are
ear	eat
fisease	disease
pne	one
tou	you
brigltly	brightly
elocked	shocked
loat	lost
rompletely	completely
hied	tied
ahere's	there's
fife	life
in	on
pgotos	photos
railyay	railway
brifges	bridges
bedind	behind
g	a
s	a
fir	for
iuildings	buildings
bn	on
wat	eat
stugg	stuff
differnr	differnt
rading	riding
ihere	there
cpllapsed	collapsed
flyinh	flying
falking	walking
ohotos	photos
whioe	while
yelloe	yellow
befas	sofas
apending	spending
pleasmnt	pleasant
sone	some
artifival	artifical
sne	one
wverythingyou	everythingyou
bmall	small
bew	new
dollen	wollen
habds	hands
cought	caught
bo	no
tow	top
next	nexk
adtration	attration
ovserve	observe
his	hit
loods	looks
sean	seen
infromt	infront
showinf	showing
cbour	abour
iooks	looks
golg	gold
wattr	water
sity	city
gog	dog
st	on
wscape	escape
scaking	scating
tem	i'm
wnd	and
birdd	birds
rou	you
lead	leaf
bella	belly
imat	what
vs	is
hoy	joy
elluminates	illuminates
woman	women
ahis	this
cs	is
an	in
fo	to
tus	bus
frnends	friends
on	of
ine	the
mf	of
fedication	indication
tore	fore
women	woman
thd	and
frony	front
laye	late
whire	white
haopened	happened
on	in
an	in
read	road
aicture	picture
rover	river
dearfs	dwarfs
tn	in
wonan	woman
thke	like
ney	net
fkiwering	flowering
makeng	making
s	a
gorl	girl
strret	street
at	on
resying	resting
photograpjy	photography
sprite	spirit
enjouing	enjoying
coudh	couch
size	side
colurful	colorful
wilner	winner
chilg	child
ihis	this
shrip	strip
olone	alone
out	put
minal	final
vovered	covered
shawow	shadow
whe	why
everyines	everyones
os	of
thr	the
yho	who
ahe	the
ehe	the
berfectly	perfectly
rided	rides
tois	this
suphorized	authorized
prople	people
ihis	this
uh	we
an	in
if	of
epmty	empty
waining	waiting
aeave	leave
sway	away
ezcape	escape
hw	he
relacing	relaxing
iab	cab
os	is
derty	dirty
staids	stands
surfuce	surface
in	on
blear	clear
backet	basket
poy	toy
trting	trying
silden	golden
os	us
bout	boat
brazillan	brazilian
kjugfu	kingfu
lookd	looks
o	i
wea	sea
an	on
hf	of
yer	her
artisy	artist
dhat	that
clack	black
rtatue	statue
precticing	practicing
s	a
favoutite	favourite
btanch	branch
oy	by
smokung	smoking
tyoe	type
lare	lake
vry	cry
bt's	it's
coulf	could
dnwn	down
shairs	chairs
hjge	huge
thw	the
grafitti	graffiti
tress	trees
sillouette	silhouette
mu	my
hray	gray
poy	you
twe	two
reaearch	research
wha	who
doen	down
dote	cute
aronge	orange
weach	teach
nesr	near
manlim	muslim
on	in
hestaurant	restaurant
gunny	funny
smokimg	smoking
aleays	always
ophone	iphone
thise	these
perosn	person
replected	reflected
oszing	oozing
ens	its
works	worls
rubbon	ribbon
ware	were
ballooks	balloons
wlways	always
bekueve	believe
kook	look
coiorfully	colorfully
mointain	mountain
doord	doors
cominf	coming
momentic	romantic
nhat	that
dore	door
mu	my
wrom	from
utiside	outside
colorgul	colorful
birs	bird
wverything	everything
ihis	this
gor	for
mo	go
doen	down
firls	girls
pwrson	person
baithday	birthday
hoe	how
saddy	daddy
drom	from
plauing	playing
buddles	puddles
dear	dead
atanding	standing
yound	young
scraf	scarf
gloor	floor
meaople	peaople
aline	alone
straitht	straight
wiyh	with
teautiful	beautiful
whar	what
kess	kiss
noss	moss
tn	on
jaint	gaint
sangerous	dangerous
accupying	occupying
teedy	teddy
flowi	flown
aueartifull	bueartifull
w	a
paul	raul
og	of
sellow	yellow
tm	im
haning	having
certioin	certiain
wverywhere	everywhere
snall	small
ot	it
class	glass
biclcle	bicycle
b	a
simulal	simular
whth	with
iooks	looks
wrgo	ergo
tye	the
dreas	dress
weautfully	beautfully
awe	are
lode	lofe
becjh	bench
splaches	splashes
arer	over
foll	full
vovered	covered
somethimg	something
wolds	holds
babu	baby
ab	as
liok	look
whote	white
aross	cross
ttees	trees
aea	sea
flyt	flya
quete	quite
aae	are
whcih	which
firls	girls
riseng	rising
a	i
misdle	middle
protein	protien
tntil	until
the	tre
cebile	mobile
rainboct	raincoat
ahe	the
call	will
tazing	gazing
biddle	middle
buautiful	beautiful
butterfuy	butterfly
cutess	cutest
whthout	without
ian	can
vome	come
lovb	love
nohting	nothing
puss	push
dag	dog
photoggaphs	photographs
bubnles	bubbles
easing	eating
werve	serve
sl	is
li	am
ie	we
phptp	photo
distence	distance
worher	worker
sttractions	attractions
atr	for
ather	other
mir	car
desugn	design
woh's	who's
qgly	ugly
pickure	picture
loing	lying
atd	and
balace	palace
hald's	hold's
tooth	teeth
sneekers	sneakers
theth	teeth
gojng	going
oppasite	opposite
ag	in
stsring	staring
peopls	people
touthing	touching
happt	happy
furl	girl
ws	is
pew	few
girr	girl
iehind	behind
reciebe	recieve
leseaur	liseaur
tn	in
balck	black
in	on
doat	boat
angs	legs
wook	look
wycle	cycle
caby	baby
aon	won
tolf	told
tousist	tourist
sgare	share
my	by
mon	mom
dont	don'
ia	is
vacane	vacant
sutfing	surfing
clcle	cycle
forning	morning
var	far
ywo	two
beugtiful	beautiful
moents	mments
oy	my
wiew	view
fas	has
feridious	ferocious
tlear	clear
acrass	across
ir	it
duitar	guitar
phildren	children
tha	the
whote	white
lhought	thought
redung	reding
desitn	design
u	i
swin	swim
af	of
smain	train
ter	her
toothvrush	toothbrush
ahrough	through
girnt	giant
bhe	the
boes	boys
wonden	wooden
aome	some
weaeing	wearing
ind	and
acally	really
ssimming	swimming
groung	ground
im	am
dir	gir
firld	field
car	cat
everyine	everyone
partifipants	participants
bouse	house
yf	if
aitting	sitting
fbove	above
ouf	out
wwite	white
visitid	visited
gog	dog
eo	to
licky	lucky
sity	sits
taci	taxi
eyebrol	eyeball
os	is
tto	too
stake	skate
thrre	three
lef	leg
creae	crepe
mhese	these
oh	on
meen	been
bly	sky
montter	monster
swmmig	swmmng
got	get
uou	you
es	is
sew	saw
dest	best
itand	stand
froends	friends
while	whole
icr	ice
af	of
h	i
sueanty	pleanty
kilsing	kissing
mangle	single
glacs	glass
quire	quite
ihe	the
ap	up
guage	guard
thrarical	thatrical
lolling	looking
ot	at
drass	grass
motehr	mother
burl	girl
slavcry	slavery
fluing	flying
aen	men
vorn	born
wiods	woods
tabe	tape
fow	few
an	on
doing	going
gos	god
joazon	amazon
stints	stunts
flovers	flowers
waitiug	waiting
groas	gross
git	hit
sidelalk	sidewalk
taue	blue
drr	dry
gog	dog
aut	but
qith	with
pamel	camel
crasher	crashes
gn	on
sooden	wooden
sirl	girl
thr	the
tith	with
uou	you
siz	six
nest	next
beacj	beach
ufp	ufo
wwaring	wearing
prodicts	products
fiels	field
oranve	orange
cysves	cycles
a	s
wim	win
secutity	security
eld	old
branckes	branches
wlectric	electric
fanally	finally
sed	red
glag	flag
tubbles	bubbles
whut	shut
sont	dont
relazing	relaxing
anm	and
bhe	the
hpney	honey
beauriful	beautiful
floweng	flowing
wonan	woman
shous	shoes
salk	walk
buildis	buildig
tew	few
bkack	black
persond	persons
sas	has
yeelow	yellow
plaved	placed
mhis	this
swarfs	dwarfs
croup	group
rhey	they
eho	who
sunny	funny
wits	sits
hight	right
vlack	black
galling	falling
we	is
engoying	enjoying
buoldings	buildings
waating	waiting
wirh	with
lead	leaf
hooting	rooting
racks	rocks
pw	tw
flu	fly
helo	help
aumping	jumping
searing	roaring
og	of
ar	at
goona	gonna
vert	very
tiday	today
picto	photo
aut	out
neal	near
moman	woman
wikh	with
compuud	compund
beartiful	beautiful
amnk	pink
cucloning	cycloning
golds	holds
ot	or
aew	are
chicdren	children
bajk	back
epend	spend
plat	play
smoae	smoke
lall	tall
uou	you
mlues	blues
firls	girls
inderground	underground
ro	to
ahe	the
neat	next
as	is
ot	it
toung	young
totator	rotator
whwre	where
aamost	almost
tike	like
youngsetrs	youngsters
proun	proud
raileay	railway
chiclred	childred
wee	see
timr	time
uou	you
fl	is
benind	behind
strippd	striped
behand	behind
if	of
bridht	bright
curring	cutting
iy	it
blers	bless
coung	young
thet	they
eas	was
facourite	favourite
in	on
insexts	insects
unconciousness	unconsiousness
fiols	fiels
climps	climbs
griup	group
t	a
aery	very
dringing	drinking
somw	some
bellage	village
shite	white
mt	my
tou	toy
attaced	attache
oh	of
maching	machine
extuacting	extracting
crewd	crowd
fix	six
nest	best
hester	master
ny	my
mhe	the
woamn	woman
are	art
os	is
saimming	swimming
stadyum	stadium
an	in
trytng	trying
waier	water
o	i
weathet	weather
colorfil	colorful
show	snow
ot	it
wayer	water
sets	sits
lourve	louvre
drims	drums
lhe	the
leada	leads
aown	down
sjoking	smoking
cand't	can''t
bicyvle	bicycle
grils	girls
mab	man
p	a
mo	me
starue	statue
du's	it's
conld	could
me	on
blants	plants
ho	is
aolor	color
vrown	brown
bloth	cloth
kooking	looking
sould	would
pocketbuok	pocketbook
theue	theie
standing	standind
ti	to
an	by
me	my
ord	old
id	is
woo	wow
lones	bones
pleasw	please
sundlower	sunflower
roxket	rocket
hiw	how
ot	at
smike	smile
birk	bird
womwn	women
cite	cute
trres	trees
nor	for
ricks	rocks
maving	having
wair	hair
lellow	yellow
lo	so
chatecter	character
joice	juice
plwl	bowl
mounh	mouth
it	is
sonderfull	wonderfull
strret	street
surger	surfer
loke	like
gode	code
wie	she
wide	wife
ofe	one
k	i
hekp	help
in	to
os	on
whll	will
like	lake
doe	dot
thr	the
grasshopoer	grasshopper
for	too
roccy	rocky
banset	sunset
csrry	carry
maching	machine
cas	car
bng	big
ihere	there
keg	leg
smokong	smoking
lood	look
anonf	alonf
pne	one
oh	of
ay	my
bollows	billows
guees	guess
everyine	everyone
walkray	walkway
ao	to
yery	very
goggy	foggy
mouitains	mountains
crunvh	crunch
onf	off
lilent	silent
scenery	scenary
abd	and
wown	down
hading	hiding
seriyus	serious
trssenger	passenger
fromt	front
swin	swim
kike	like
pedistrian	pedestrian
dinging	dinking
bunch	banch
takeng	taking
wubber	rubber
protecticely	protectively
lokk	look
typeng	typing
sheering	cheering
aeiling	ceiling
looo	look
hodden	wodden
yhe	the
sook	look
onder	older
tee	see
v	a
reaves	leaves
tfe	the
sopeone	someone
conversarion	conversation
ahe	the
sn	in
ivening	evening
possibhy	possibly
wnowy	snowy
it	in
sjow	show
giow	show
metter	better
eye	the
fike	like
goodba	goodby
aot	lot
palnts	plants
runnung	running
ihines	shines
how	who
worhing	working
bide	side
standinh	standing
women	woman
v	i
workd	world
sallen	fallen
wo	go
crimg	cring
mirroe	mirror
sre	are
shows	shoes
iou	you
fperating	operating
rpartment	apartment
noe	now
fhe	the
jid	kid
wowing	rowing
sin	sun
yound	young
passinf	passing
conctet	concret
fifferent	different
yoy	you
ii	in
olumpics	olympics
eaual	equal
eh	ah
ane	are
nor	not
mtmat	mymat
wives	gives
weflected	reflected
iny	any
chese	these
ihen	when
coccer	soccer
swinm	swimm
mush	much
reis	this
there	their
sngry	angry
hor	for
undergrownh	undergrowth
telephond	telephone
injourioe	injourios
adversises	advertises
sho	sea
thrtw	throw
senl	seml
gre	are
on	in
d	a
whe	she
meke	make
suburd	suburb
itn	iin
waering	wearing
rhis	this
admiting	admiring
doorsay	doorway
myer	over
sepeate	repeate
mnd	and
don'y	don't
awo	two
helking	helping
heyone	anyone
narroe	narrow
shorw	shore
staning	stading
crumcle's	crumble's
haneymoon	honeymoon
ihe	the
woodem	wooden
ws	is
thriugh	through
clpsing	closing
wheller	wheeler
gool	good
ao	do
sesert	desert
fanatstic	fantastic
faving	having
riber	river
srees	trees
piccure	picture
subber	rubber
wonderinf	wondering
wottles	bottles
lansing	landing
ptunami	psunami
ceep	keep
lide	side
injourioi	injourios
sig	six
heir	hair
pepoes	peples
dooses	gooses
dalmotion	dalmation
tomplete	complete
chaped	shaped
o	a
counerng	counting
capruted	captured
cick	kick
antoqute	antiqute
apop	atop
pright	bright
puooy	puppy
ilease	please
mofel	model
theyr	their
iun	sun
workd	world
wake	make
windoe	window
hooden	wooden
honeynoon	honeymoon
ny	by
dmoking	smoking
trah	trak
sexurity	security
pre	are
think	thick
wn	in
dof	dog
ladam	madam
aline	alone
betal	metal
excersise	excercese
whownn	shownn
banies	babies
pastryes	pastries
namming	napping
stanfing	standing
vever	never
wiyh	with
os	of
kight	night
waitimg	waiting
irritete	irritate
peolpe	people
wer	wet
towals	towels
disturded	disturbed
btight	bright
ghe	the
ore	are
narriw	narrow
baught	bought
bo	so
migger	bigger
sony	many
iuitar	guitar
cicture	picture
selongs	belongs
fing	wing
sleepu	sleepy
squantered	squandered
pick	pink
see	saw
veiw	view
ts	is
aklso	allso
roords	boards
ie	we
yor	for
tnother	another
hehind	behind
reflecteng	reflecting
hesd	head
colorf	colors
kooks	looks
technologyes	technologies
vovered	covered
sope	some
fale	male
ocesn	ocean
t	i
goinh	going
an	on
cut	cup
sku	sky
dockfille	dockville
wark	park
avove	above
iclcles	icicles
styleng	styling
so	is
reafy	ready
woamn	woman
qhen	when
oeauty	beauty
desetred	deserted
peplace	replace
neu	you
mw	me
palade	palace
ummrella	umbrella
nee	see
lickiest	luckiest
drivet	driver
tourhing	touching
wides	rides
lind	line
pleasw	please
uou	you
threshood	threshold
ins	its
cyns	mens
swbway	subway
ids	iis
pidfeon	pidgeon
mountaind	mountains
seautiful	beautiful
st	it
ehat	what
arroe	arrow
gigt	gift
hump	jump
mummm	mummy
alanding	standing
o	i
babe	baby
disign	design
me	my
eceans	oceans
iniluding	including
sowo	shwo
thl	tel
tolp	help
whtir	their
uou	you
hitting	sitting
thes	this
suer	sute
robacco	tobacco
womewhere	somewhere
tan	man
kigt	gigt
botthe	bottle
aew	new
thes	this
umbrilla	umbrella
handed	hanged
gnes	gems
windiw	window
hirl	girl
smokiog	smoking
arads	heads
whioe	white
bud	and
about	above
ahe	the
blae	blue
reacyed	reached
key	hey
surrounginf	surrounging
bendh	bench
whrough	through
ourside	outside
botor	motor
hueg	huge
ppace	place
doffernt	differnt
cane	came
sertain	certain
tozy	cozy
amell	small
vergin	virgin
kiking	hiking
trom	from
ailent	silent
wts	its
woamn	woman
hooper	hopper
iont	dont
olderly	elderly
ehole	whole
beautioul	beautiful
in	on
devorated	decorated
verling	feeling
bolls	balls
sets	sits
bipe	ripe
l	a
plowering	flowering
hafe	have
gendi	genci
milh	milk
prtraits	potraits
aith	with
bukket	bucket
raint	rainy
helpcopter	helicopter
mu	my
aith	with
pf	of
se	he
sery	very
s	a
on	in
anumal	animal
coooed	cooked
a	s
unifrom	uniform
n	a
an	on
exercixe	exercise
bvautifula	beautifula
an	in
sith	with
atreets	streets
pld	old
sleeo	sleep
soverd	coverd
wod	and
ets	its
photopraphs	photographs
hooby	hobby
od	of
cintrol	control
ans	and
butterfle	butterfly
recer	racer
olf	old
kafge	large
coyt	coat
litlle	little
kacket	jacket
canrt	can't
vaear	clear
meit	melt
live	like
mimera	camera
tht	out
af	of
place	plane
oile	pile
slowle	slowly
vlass	class
enhoying	enjoying
wll	all
survace	surface
bord	bird
ur	us
tim	him
ihat	that
kinfs	kinds
amazng	amaing
stapshot	snapshot
tomatows	tomatoes
od	of
kooking	looking
up	on
pregnamt	pregnant
sauser	saucer
staning	stading
naced	naked
scube	scuba
ire	are
anvient	ancient
freld	field
exepilion	exebition
shaep	sharp
pleaent	plesent
gauncher	launcher
ie	we
flaciers	glaciers
leaver	leaves
plower	flower
ire	are
ehjoying	enjoying
geavy	heavy
drenk	drink
reg	big
xostumes	costumes
ieflection	reflection
scaae	scare
wtone	stone
oul	all
sime	some
smuggles	snuggles
ald	old
siad	road
boyh	both
baople	people
toll	till
funhy	funny
lhair	chair
lanenders	lavenders
bly	fly
rirls	girls
scean	sceen
ire	are
t	a
sity	city
costime	costume
ic	is
sho	who
noihing	nothing
ahe	the
glasees	glasses
trucl	truck
ts	is
fress	dress
clous	clods
watehes	watches
vee	bee
roa	rod
whey	they
arounf	around
bight	light
fukl	full
woeld	world
perfevt	perfect
in	at
showe	shore
loke	love
whe	why
toce	nice
towm	town
goung	young
hrange	orange
dannot	cannot
wind	wing
lokking	looking
arthes	arches
tm	am
guarging	guarding
smowy	snowy
het	hey
mepty	empty
merron	meroon
crink	drink
sity	city
rool	roll
that	than
msn	man
lookd	looks
wow	how
terrosts	terrists
stratch	stretch
hiyt	hoyt
os	is
snoe	snow
sprouging	sprouting
p	a
simple	simply
ohoto	photo
at	lt
spelling	spilling
geers	beers
sbue	blue
burting	burning
ialking	walking
cuty	city
dietrub	distrub
oen	own
sjats	boats
now	new
walkinh	walking
on	in
hoth	both
ther	this
abd	and
fpring	spring
apon	upon
persin	person
leav	leaf
enjoyong	enjoying
ans	and
do	so
par	car
rething	rethink
portugest	portugese
upbrealas	upbrellas
gaahered	gathered
pnap	snap
weraing	wearing
dopr	door
od	of
beound	around
avay	away
detting	getting
lre	are
stanting	standing
crouded	crowded
ia	is
ncie	nice
onrough	through
casked	masked
cap	cup
jajanese	japanese
wre	are
finny	funny
tghs	this
a	i
kig	kid
fromt	front
dlowers	flowers
trirst	thirst
bickcle	bicycle
beautifuk	beautiful
corcus	circus
areoplane	aeroplane
slso	also
advirtising	advertising
wy	my
aowls	bowls
eith	with
obsessivr	obsessive
gorl	girl
yes're	you're
noe	now
tld	old
st	is
beaufiful	beautiful
santo	santa
heer	hear
mlack	black
the	top
put	out
nlack	black
wid	and
suench	trench
tunshine	sunshine
wanhed	washed
fitht	fight
vrashing	crashing
fo	go
bainking	drinking
citting	sitting
rade	ride
o	i
vrok	frok
windoes	windows
cucycle	bycycle
pershed	perched
liiks	looks
af	of
hhla	hula
bastet	basket
plackd	placed
talloed	tatooed
risting	resting
c	a
holoing	holding
antera's	antena's
oaby	baby
whth	with
danses	dances
ted	red
tancing	dancing
iook	look
boar	boat
perals	petals
thw	the
piny	play
geautiful	beautiful
tetwen	betwen
fet	get
ofher	other
towarde	towards
leeds	leads
srange	orange
iu	in
falk	walk
rinning	running
plas	play
tress	trees
hasit	visit
fou	you
thabk	thank
nade	made
th	my
th	is
ti	to
peaples	peoples
charp	sharp
come	some
shote	shore
sixed	sized
slleping	sleeping
heind	behnd
sire	site
in	on
glads	glass
witting	sitting
freen	green
sany	many
flu	fly
fiels	field
can't	don't
wour	four
oittle	little
shinking	thinking
ary	try
dups	cups
mamy	many
underwaner	underwater
ao	so
amaxing	amazing
soop	soup
recorated	decorated
ot	of
beautifil	beautiful
site	side
trere	there
uf	of
betwwen	between
yelloe	yellow
aver	over
ovst	obst
doorknog	doorknob
sis	his
provessions	professions
komputer	computer
happend	happens
te	he
aeroplaces	aeroplanes
funerel	funeral
if	of
uou	you
my	by
ome	one
bubbleslower	bubbleblower
sipping	nipping
goi't	don't
chikdren	children
peopke	people
beaeath	beneath
ay	by
srow	grow
foffee	coffee
skilla	skills
tha	the
ias	eas
tn	in
flautiful	beautiful
gad	bad
fgom	from
plave	place
atanding	standing
dive	give
binini	bikini
io	is
bridbe	bridge
af	of
tnstrument	instrument
ots	its
man	men
gands	hands
read	road
dhis	this
awo	two
manu	many
tungue	tongue
rike	like
croeded	crowded
parrllel	parallel
poseure	posture
beautirul	beautiful
deh	teh
tailways	railways
lesting	resting
are	all
cace	face
seimming	swimming
wicket	wicker
trittenin	writtenin
foolball	football
ia	is
wherw	where
wn	on
pltting	getting
perton	person
hoing	going
mmod	mood
wver	ever
coustumers	coustomers
q	a
daoomy	gloomy
gihe	give
nned	need
iys	its
ond	and
rockl	rocky
incication	indication
wazing	gazing
buolding	building
eood	good
memmers	members
swimminh	swimming
io	is
beust	bjust
wan	was
wat	fat
florer	flower
ar	at
b	a
ahether	whether
te	pe
statce	statue
fedore	fedora
rool	roll
walt	walk
on	in
rrsearch	research
oilve	olive
hy	my
shorth	shorts
frends	frinds
sustome	custome
t	a
seeting	setting
fress	dress
beautuful	beautiful
thruogh	through
aq	am
balcany	balcony
waa	was
patted	potted
eith	with
biry	very
ind	and
forst	first
test	rest
gfman	woman
whoh	with
yop	you
ies	yes
windowd	windows
th	to
firls	field
sental	rental
st	is
nece	nice
blaying	playing
oext	next
thr	the
tp	to
lank	land
nect	next
whth	with
ar	is
fransisco's	francisco's
t	a
foshes	fishes
tor	for
inpartue	departue
ae	me
became	become
m've	i've
wich	wish
fo	to
bind	bins
aymbol	symbol
thurit	thirst
she	the
ihe	the
ny	by
tou	you
iust	just
jumming	jumbing
fing	find
nll	all
id	is
ihite	white
friendz	friends
card	cars
prople	people
plrase	please
htunning	stunning
taithful	faithful
frint	front
beiutiful	beautiful
crows	crowd
walkinf	walking
thh	the
earing	eating
ahe	the
bmue	blue
beaytiful	beautiful
drawb	drawn
moubtain	mountain
poad	road
frur	four
kike	like
af	of
differrntly	differently
batter	patter
ant	and
thw	the
an	am
practicing	practising
nt	at
groeng	groung
carge	large
aodern	modern
dide	side
hoe	how
celp	help
sittind	sitting
aeautiful	beautiful
t	a
s	i
coller	cooler
batctub	bathtub
repersussion	repercussion
tailway	railway
dou	you
theough	through
agead	ahead
og	of
vows	cows
neat	near
bucycle	bicycle
eor	for
paloons	baloons
sayd	said
lolored	colored
rlflection	reflection
saoes	shoes
attaching	attacking
fnow	snow
tor	for
on	in
thrir	their
noy	not
hap	cap
rs	is
s	m
staging	stading
woold	would
colrectly	correctly
led	red
lokk	look
dr	is
surple	purple
kikers	hikers
ay	at
idie	idle
nevvr	never
sttraction	attraction
cyuling	cycling
aill	will
sot	sit
amesement	amusement
teo	two
is	it
hoving	loving
ohole	whole
alwaus	always
nall	ball
stook	stood
pleasr	please
tracter	tractor
ia	is
unwarn	unworn
fs	as
ane	one
sitt	sits
bndigo	indigo
toing	going
mlanting	planting
huyger	hunger
ovive	olive
baskground	background
thet	that
sheel	sheep
supernan	superman
cone	come
dtruck	struck
tiereis	thereis
hn	an
rrin	rain
hea	hey
frineds	friends
everytay	everyday
gtoup	group
yrllow	yellow
ohoto	photo
thete	there
mt	my
cop	cap
inidst	amidst
swin	swim
pwrson	person
stanfing	standing
beautifyl	beautiful
the	she
in	at
top	toy
brckground	background
smail	snail
bn	on
whown	brown
soen	seen
rie	the
tut	out
fo	no
voats	boats
on	in
uf	of
rood	roof
menbers	members
anf	and
cy	or
bloe	blow
steeping	sleeping
contume	costume
k	i
causht	caught
came	come
prople	people
placee	placed
ewith	wwith
burren	barren
atcached	attached
tis	his
listin	listen
tou	you
ms	is
bnto	into
mu	my
cmpty	empty
ofer	over
sir	sit
giveng	giving
tith	with
t	i
enjpying	enjoying
balloa	ballon
poeple	people
wooan	woman
per	her
nucket	bucket
cus	bus
in	is
beautifyl	beautiful
christmsd	christmas
aweet	sweet
fuw	new
ty	my
whu	why
hemlo	hello
wnd	and
plsh	dish
sad	bad
kike	like
ballowns	balloons
figgy	foggy
ehe	the
by	my
ia	in
siands	stands
didi	didn
cecorum	decorum
deadh	death
booh	book
whese	these
can'y	can't
frand	grand
iear	near
grpup	group
chirch	church
lokks	looks
conrer	corner
pf	of
sallon	saloon
podsibly	possibly
sly	sky
shispering	whispering
gog	dog
wiih	wish
beauthful	beautiful
looos	looks
cone	come
firl	girl
lontly	lonely
nech	neck
pun	put
o	a
hapt	kept
bhip	ship
mommy	mummy
tuste	paste
glue	blue
magiv	magic
wook	look
th	is
fery	very
st	it
bog	big
behide	beside
alobe	alone
heiii	haiii
waal	wall
tyoe	type
ole	the
wlaking	walking
in	on
exploses	explodes
rave	race
foft	soft
unto	into
thi	the
tha	the
ter	her
visiule	visible
alo	all
obove	above
seanon	season
know	snow
useng	using
feddish	reddish
thw	the
iere	were
challangeng	challenging
alont	along
thw	tow
appaeciate	appreciate
wh	we
gamily	family
iy	my
chiold	chiild
amd	and
tne	the
then	than
an	on
fo	do
ie	we
emew	crew
out	our
stabd	stand
whis	this
buddle	puddle
bod	big
t	i
nand	hand
in	on
bwtween	between
woth	with
se	be
kises	kites
woeld	world
howderful	wonderful
o	i
ihe	the
ha	is
gkitering	glitering
bume	come
picturisation	picturization
aeriplane	aeroplane
sust	just
glass	grass
coff	cows
dolphing	dolphins
cat	say
liguid	liquid
takimg	taking
exebicion	exebition
of	to
af	of
sove	give
sinting	sitting
dlice	slice
firewook	firework
pest	just
seirous	serious
bastet	basket
enjor	enjoy
indide	inside
just	jugs
tantarn	lantarn
ny	by
carera	camera
brightiy	brightly
stap	stop
epending	opending
lace	face
slying	flying
froom	groom
bakck	black
tou	you
beautyfull	beautifull
takin	taken
eojoying	enjoying
vsed	used
sceneri	scenery
ont	out
og	of
com	can
lobe	love
coun	gown
downtridden	downtrodden
what	that
in	on
electeic	electric
ie	me
shitrt	shiirt
worlg	world
class	glass
a'm	i'm
sreaming	dreaming
homw	home
putside	outside
rrlaxing	relaxing
biethday	birthday
subsay	subway
dors	dogs
mecico's	mexico's
mi	my
aeople	people
robbcco	tobacco
wut	but
eith	with
begind	behind
riber	river
an	in
bois	boys
nkce	nice
serds	birds
realisind	realising
snside	inside
mtund	stund
o	i
mad	man
arounf	around
frim	from
clelvbrating	clelebrating
sighal	signal
flowees	flowers
sot	hot
sub	suv
whar	what
rounn	round
mat	may
supting	sitting
ofher	other
bireies	birdies
ire	are
ohrough	through
onlt	only
waht	what
acrocs	across
pariy	party
orfer	order
yrar	year
hawse	howse
ping	pink
garying	carying
is	to
readu	ready
mow	how
wow	how
vaiting	waiting
sjder	under
flore	flowe
righ	ride
pivnic	picnic
bictcle	bicycle
sisging	singing
w	i
grave	graze
wisable	visable
cre	are
wwich	which
bondles	candles
nusic	music
ws	is
lifgt	light
amd	and
enjine	engine
it	is
thineese	chineese
pimilar	similar
cum	gum
factury	factory
pont	dont
tp	to
whre	wire
iwisj	iwish
yhe	the
closk	clock
my	by
collur	colour
trlking	walking
whice	white
pearing	peering
wameone	someone
set	jet
practrce	practice
afrais	afraid
climbe	climbs
noy	not
ltatue	statue
rujrtle	tujrtle
tries	trees
sepprate	seperate
og	of
w	i
hver	over
tomorrowm	tommorrow
patternbd	patterned
dtraw	straw
do	to
wh	oh
gresses	grasses
emmtting	emitting
thme	some
con'	can'
burterfly	butterfly
ihating	chating
fidh	fish
ahe	the
hos	his
wanr	want
enjoi	enjoy
post	most
aowards	towards
deed	need
wonferful	wonderful
visitore	visitors
widhes	wishes
tha	the
flows	flown
workd	world
wake	take
jravy	heavy
dough	tough
tood	good
bloeing	blowing
whitw	white
lhe	the
firls	girls
tn	in
atanding	standing
aoon	soon
cupple	couple
thes	this
bycycle	bicycle
walla	walls
wityout	without
ion'	don'
whyre	where
scy	sky
btter	etter
can	tin
aew	are
dont	don'
bycicle	bicycle
fan	can
excercide	excercise
tou	you
jannot	cannot
dofferent	different
flothes	clothes
uou	you
ws	is
titht	witht
reoresented	represented
tine	time
thr	the
noe	now
animaks	animals
here	hear
th	an
pld	old
bach	bech
plave	place
ifself	itself
anione	anyone
w	a
backfround	background
twi	two
facourite	favourite
colurs	colors
along	alone
ghing	going
surge	large
stane	stage
undersater	underwater
jat	hat
jakket	jacket
planr	plant
coes	cows
iooking	looking
dall	doll
enpty	empty
jeens	jeans
graasy	grassy
wat	eat
tkaes	takes
runn	runs
if	of
laundhed	launched
mt	my
natitnal	national
irrttate	irittate
friengs	friends
chite	white
sity	city
festroyed	destroyed
mote	more
lood	look
unsean	unseen
aa	at
nect	next
thidrends	chidrends
earmy	early
beaterflay	butterflay
ather	other
fed	red
veew	view
fron	from
sthnding	standing
on	in
ihe	the
cure	cute
hifh	high
danage	damage
tows	toys
fellow	yellow
soe	the
siying	laying
liiks	looks
wea	sea
ese	use
asn'	isn'
stutue	statue
bven	even
ywllow	yellow
florenceiost	florencemost
wathing	washing
pitutre	picutre
aboue	above
tn	in
fase	face
dricing	driving
tn	in
slow	snow
uou	you
cleat	clear
pere	were
boate	boats
soory	sorry
ita	its
upder	under
islan	islad
tradioional	traditional
cicycle	bicycle
roan	road
gogether	together
ir	it
i'a	i'm
ne	me
there	their
beauyiful	beautiful
sicture	picture
aroind	around
wre	are
sity	city
si	am
plinting	painting
bhite	white
insturument	insttrument
surnishing	furnishing
juut	just
rick	rock
xoloured	coloured
muman	human
shatting	chatting
eassive	massive
icalthy	healthy
hisguisting	disguisting
nont	dont
tyoes	types
og	of
amd	and
i	a
adversises	advertises
in	it
reglecting	reflecting
syanding	standing
places	placed
wann	want
feild	field
davy	navy
therything	everything
paol	pool
emjoying	enjoying
manbe	maybe
tehe	thhe
weeding	wedding
wothout	without
buy	boy
whhelres	wheelres
cn	in
tadhana	sadhana
comeone	someone
set	sit
artisr	artist
gangaroes	kangaroes
cylandir	cylander
isass	glass
ahe	the
kind	king
tjis	this
tlke	take
id	is
vat	cat
thier	their
tlease	please
skark	shark
im	i'
bloves	gloves
earty	early
mab	man
secirity	security
lhoto	photo
fown	down
arw	are
kokes	jokes
leaveng	leaving
childrem	children
tgree	three
af	of
rough	tough
aal	all
grall	grass
aheas	ahead
toou	yoou
eatch	catch
blie	blue
blear	clear
how	now
gree	tree
sn	in
kuttle	little
wiew	view
vcgas	vegas
frown	brown
veru	very
whene	where
patc	path
buetifell	buetifull
monent	moment
cab	can
throuing	throwing
lids	kids
ant	any
class	glass
stadue	statue
filds	field
lvenly	evenly
inack	black
go	as
soses	poses
pict	pick
tith	with
wmbarassing	embarassing
tosing	posing
cdr	car
blus	blue
bighnd	bigand
thsre	there
benck	bench
fater	water
beautuful	beautiful
mait	wait
cant	can'
witl	will
jumppng	jumping
eaiting	waiting
sl	ll
violinr	violine
wonan	woman
stiring	staring
childisg	childish
blacj	black
alower	flower
p	a
smands	smaids
wown	gown
ebery	every
adandoned	abandoned
fiels	field
okease	please
wan	man
hi	hy
kave	have
te	he
powdly	poudly
prrof	proof
hetting	hitting
buter	buyer
fromt	front
folored	colored
leag	leaf
srern	stern
an	in
ar	as
skup	skip
disrurb	disturb
pessage	message
begr	near
in	on
blowiig	blowing
as	at
probmem	problem
chast	chest
gell	fell
mioking	looking
cilumns	columns
man	men
ofter	after
cook	cool
thus	this
tith	with
al	in
vlear	clear
wodden	wooden
varietied	varieties
yoe	the
pna	ona
sowl	bowl
mushrron	mushroon
nahd	hand
whwre	where
betting	getting
neee	need
plfferent	different
neach	beach
sable	table
ao	do
omdel	model
thl	all
then	when
adter	after
adup	acup
man	men
ohen	when
pake	make
conxert	concert
sonny	sunny
ti	to
kapsicum	capsicum
inis	this
vety	very
ans	and
norning	morning
itylish	stylish
ls	is
colorfil	colorful
s	a
goman	woman
amomated	animated
y	t
yo	do
hosbital	hospital
lend	bend
cater	water
ihis	this
handng	hangng
aboue	above
clanket	blanket
binlio	biblio
whrough	through
t	a
tondue	tongue
tonderful	wonderful
toxt	next
lmall	small
automatioally	automatically
worling	working
by	my
piur	pour
brautiful	beautiful
oell	tell
i	a
a	i
sjop	shop
on	in
sittiug	sitting
kinf	kind
mellow	yellow
ang	and
fiding	riding
ctane	crane
wodds	woods
tatally	totally
parting	parking
rating	eating
com	can
fltover	flyover
carnical	carnival
clover	cloves
tire	ture
bubblea	bubbles
ploy	play
orgnge	orange
hostest	hottest
uou	you
charchter	character
burnong	burning
hnow	snow
buts	puts
ae	we
grige	brige
yake	take
un	on
an	on
mquare	square
tipped	dipped
shory	short
anos	alos
put	out
whis	whos
lonedy	lonely
on	in
avay	away
she	one
woth	with
freen	green
delisious	delicious
ws	is
wonan	woman
peeple	people
roog	roof
ise	are
winder	winter
limmt	limit
pig	big
canyt	can't
friving	driving
malffnctioned	malfunctioned
anly	only
as	is
ay	by
bed	red
pubby	puppy
iake	cake
birt	bird
slowiy	slowly
roday	today
wpman	woman
midieval	medieval
hay	hey
standong	standing
aolding	holding
pirls	girls
gor	for
guod	good
chilken	chicken
walki	walks
if	of
panfa	panda
diamong	diamond
tis	its
bild	bold
htay	stay
in	at
if	of
accoss	across
iey	hey
on	in
swin	swim
agter	after
sha	the
waue	blue
og	of
hilds	holds
mjch	much
orande	orange
carinr	caring
ballook	balloon
ree	red
in	by
kis	his
secutity	security
chite	white
t	a
doen	down
ded	bed
croos	cross
apop	atop
dayving	daiving
cundow	window
tho	the
os	is
fappy	happy
drivir	driver
lary	lady
wnl	onl
cupfee	coffee
werson's	person's
veiw	view
sion	soon
uou	you
unbrella	umbrella
curcular	circular
boker	biker
bo	so
ste	are
gkass	glass
bhite	white
seatid	seated
an	in
begginf	begging
ne	me
dirious	various
aearing	wearing
higgest	biggest
camere	camera
think	thing
tqo	two
hs	is
hogewrts	hogwarts
koke	joke
factort	factory
iutnit	butnit
nidn'	didn'
iakes	makes
ter	two
palding	holding
cathereral	cathederal
dhvs	this
thid	this
mw	me
ire	are
wuth	with
in	on
food	good
year'	years
lohg	dohg
liktle	little
complte	compete
aonely	lonely
there	these
thide	thise
dree	tree
sku	sky
fiald	field
prople	people
photographu	photography
pensons	persons
durinf	during
frink	drink
bouse	house
hoese	horse
myted	mybed
shoep	sheep
id	is
mam	man
bidies	bodies
aicycles	bicycles
womwn	women
ehether	whether
ti	to
aggg	eggg
rip	top
bit	but
iear	near
hhy	hey
ps	is
beautifyll	beautifull
ice	icy
cycke	cycle
fet	get
us	is
ches	chew
incomeing	incomming
bell	well
lf	of
becsuse	because
snall	small
againgt	against
nan	man
wow	now
derved	served
mofern	modern
gile	pile
haw	how
umbrealls	umbrellas
groun	green
ehe	the
specual	special
ie	we
do	is
lalking	talking
vefore	before
weading	reading
theit	their
aaways	always
companu	company
iven	even
raon	rain
amall	small
tricicle	tricycle
an	at
capruted	captured
soeed	speed
feer	fear
tonna	gonna
prought	brought
diw	die
an	is
mak	man
takong	taking
en	on
od	of
camere	camera
io	no
htat	that
woiter	loiter
isoking	looking
grenert	grenery
oy	my
frying	trying
elimonates	eliminates
behing	behind
loneyome	lonesome
rird	bird
danged	hanged
mwo	two
containd	contains
dreased	dressed
vet	vey
toth	with
het	get
anth	with
c'm	i'm
picrure	picture
loveble	lovable
emply	empty
prasses	grasses
unbrellas	umbrellas
srees	trees
wplashing	splashing
nneyuin	nnequin
golding	holding
musival	musical
ritirement	retirement
flowting	floating
seeting	setting
on	in
gloomm	gloomy
ve	be
amerocan	american
chindrens	childrens
aeople	people
shoeing	showing
lie	are
workong	working
dridge	bridge
lolour	colour
is	in
fl	is
ge	be
t	a
falled	fallen
weside	beside
ar	or
recoiding	recording
io	in
women	woman
yhis	this
ib	in
yhe	the
ihey	they
adter	after
sittle	little
tere	here
gadies	ladies
behing	behind
solly	silly
fishi	fishs
liploding	exploding
mhis	this
colourfel	colourful
ob	on
quards	guards
ahe	the
comteel	costeel
nect	next
memmers	members
fougot	forgot
mommy	mummy
barson	person
babric	fabric
an	am
tont	dont
vh	oh
beay	heay
lettle	little
wonter	wonder
colcony	balcony
intil	until
reaearch	research
thim	thin
hnasome	hansome
balck	black
if	of
broen	brown
mammy'	mummy'
a	i
thg	the
holl	hill
sut	sit
bery	very
setellite	satellite
creen	green
gided	hided
decordtes	decorates
crhistmas	christmas
nise	nice
thke	like
windr	windy
goat	coat
inder	under
weeding	wedding
shy	why
hte	the
weally	really
amy	any
id	is
beautifuk	beautiful
pimpkin	pumpkin
othere	others
nig	big
mur	our
baptured	captured
birs	bees
ruvning	running
faughter	daughter
bycle	cycle
ssnd	sand
sence	scene
w	a
neaklace	necklace
n	i
paoer	paper
din'	don'
ob	on
puch	push
dhysically	physically
ctarting	starting
toastic	plastic
wwter	water
terroriet	terrorist
speaial	special
eater	water
contraction	contraption
peaturing	featuring
whioe	white
id	if
aline	alone
swowy	snowy
winger	winter
glass	class
baces	faces
ronk	pink
flite	white
elpace	elpaca
jumpong	jumping
hwe	hre
secutity	security
croup	group
sisturb	disturb
dup	cup
b	t
magin	magic
hait	hair
sigarette	cigarette
pgoto	photo
moubtain	mountain
womwn	woman
madern	modern
wlothes	clothes
grustrated	frustrated
weah	with
firly	girly
aa	am
waiteng	waiting
hoe	how
che	the
hangind	hanging
chy	boy
od	of
on	in
mi	my
ot	of
scols	scold
in	it
dits	dots
scy	sky
acroos	across
smakl	small
vn	in
a	i
yust	just
o	a
ranoe	canoe
inrrounging	surrounging
ans	and
wive	love
gorgious	gorgeous
sisplaying	displaying
cucs	cups
somfortabl	comfortabl
cod	and
our	out
cicture	picture
wrown	brown
if	of
op	up
songing	singing
insent	insect
come	cone
show	snow
eoneliness	loneliness
yhe	the
eant	want
perfoemance	performance
lefl	left
pin	pen
freen	green
iolding	holding
boar	boat
rele	pole
as	is
womans	woman'
thr	the
lam	lit
earrines	earrings
chrisymas	christmas
nect	next
os	is
coman	woman
withywllow	withyellow
ihe	the
bext	next
truit	fruit
epople	people
snlw	snow
sudience	audience
bacj	back
tget	that
faceng	facing
prat	pray
loss	lost
bavy	navy
tix	six
srapped	wrapped
anf	and
exrepssion	expression
oith	with
as	is
mersons	persons
tf	if
ihrough	through
di	do
gont	dont
yyung	young
home	come
manu	many
iou	you
ahe	the
cemtnt	cement
l	i
bokks	books
lite	like
shute	suite
kome	come
dully	fully
pernhed	perched
landscapld	landscaped
pnd	and
ond	and
leand	leans
sown	down
stock	stork
jellt	jelly
seperete	seperate
wiih	with
cuge	cute
boate	boats
fithting	fighting
its	his
ind	and
emprace	embrace
camel'	camels
meadon	meadow
wouse	house
pfmilk	ofmilk
conton	cotton
suring	during
peoole	people
eith	with
truck	trunk
gow	how
l	a
aitting	sitting
brige	bride
cyllen	fallen
coversd	covered
arthing	arching
promonafe	promenafe
moy	boy
awau	away
frink	drink
iy	my
sre	are
tith	with
frrsh	fresh
jelp	help
governmrnt	government
bath	path
skyrocdetting	skyrocketting
gere	here
multuple	multiple
countrys	countris
wemen	women
sleepimg	sleeping
pung	hang
finf	find
thet	that
dhilly	chilly
wh	it
chipd	chips
th	it
redding	tedding
soter	water
whe	why
ohich	which
aeay	away
enjouing	enjoying
hipe	hope
ny	my
tith	with
lirl	girl
takimg	taking
coofee	coffee
beflre	before
stitting	sittting
gaxing	gazing
plane	place
sundet	sunset
busldings	buildings
bicyeles	bicycles
nesr	near
bringe	bridge
trnker	tanker
standimg	standing
aoats	boats
signd	signs
ehere	where
pootpatch	footpatch
toung	young
bacome	become
trel	tree
cull	full
actuelly	actually
tour	your
aehind	behind
tine	wine
dummer's	summer's
ire	are
eilk	milk
olue	blue
hwy	hey
fence	frnce
sxhool	school
song	long
doing	going
fron	frog
scy	sky
raided	raised
sunglassws	sunglasses
exoensive	expensive
eben	even
fave	face
moman	woman
daved	saved
t	a
covfee	coffee
upstaers	upstares
lead'	leaf'
clothin	clothes
opposioe	opposite
yasted	tasted
oets	pets
separete	separate
poeple	people
aut	out
asth	with
my	by
oppa	oops
swen	seen
fir	for
rory	very
o	a
wayur	water
ware	wear
onle	only
beutrfull	beutifull
oersons	persons
tiel	tied
indroid	android
grasing	grazing
thll	till
spacial	special
sre	are
istside	outside
nonody	nobody
sy	my
sackt	jackt
greaa	great
on	in
fool	full
an	am
ip	up
hifh	high
bs	is
frce	face
raceng	racing
childreas	childrens
ehen	when
ehich	which
buts	nuts
musival	musical
inferted	inverted
anjoy	enjoy
colore	colors
sip	hip
sp	so
mu	my
dtrewn	strewn
tasts	casts
manuevering	maneuvering
meaia	media
todat	today
inbwtween	inbetween
inound	around
drassed	dressed
wo	go
cike	like
laties	ladies
camer	camel
thinkf	thinkg
solle	sille
fell	full
twoer	tower
aal	all
ket	get
carryung	carrying
ar	at
blowing	flowing
bite	bike
abeir	their
picketed	pocketed
amimal	animal
card	hard
stawberried	stawberries
vaiting	waiting
omder	under
darty	party
boree	bored
thete	there
croeded	crowded
seceral	several
sarrying	carrying
rools	rolls
iy	my
restaurany	restaurant
cheir	chair
valloon	balloon
aith	with
twi	two
oiver	river
destruyed	destroyed
withouu	without
ihe	the
thrir	their
beyter	better
sl	on
brache	branch
soctor	doctor
svreen	screen
waiging	waiting
my	me
is	it
mea	men
ihis	this
boad	boat
babys	babis
grlls	bulls
ehe	the
ihere	there
tn	in
booo	book
narure	nature
day	say
showsng	showing
abd	and
sacket	jacket
beautifyl	beautiful
churgh	church
ioes	does
eaxh	each
there	where
sing	sits
bake	take
theough	through
tellow	yellow
veru	vert
nhis	this
hoe	how
ckyline	skyline
thera	there
successdull	successfull
ted	red
olall	small
daid	said
hundry	hungry
t	a
slue	blue
pountain	mountain
wonan	woman
scenera	scenery
ahe	the
cop	cup
hrar	hear
movang	moving
tp	to
plames	planes
ans	and
w	i
freezinf	freezing
hanving	hanging
dombnos	dominos
piono	piano
coests	guests
ane	are
rrpairing	repairing
saking	taking
tice	nice
shopw	shope
class	glass
ramanicic	ramanitic
vatch	watch
colourcul	colourful
grliage	foliage
adge	edge
stanting	standing
perdon	person
wnen	when
as	is
an	on
iooks	looks
stip	stop
itme	time
co	go
dighty	mighty
poat	boat
vogether	together
strret	street
heer	hear
truch	truck
wain	wait
mtruggle	struggle
in	on
an	in
pictic	picnic
plops	flops
amoint	amount
tere	here
o	a
inti	into
id	is
tp	to
eaoking	looking
sefved	served
coloted	colored
sust	just
perpin	persin
posstion	position
uo	up
gooto	photo
svae	save
arraginents	arragements
wioo	will
bucycles	bicycles
bug	bee
yait	wait
wiched	wished
t	a
showung	showing
is	as
opstract	obstract
at	as
mcuh	much
iere	here
on	an
ahe	the
lirl	girl
morred	moored
scen	seen
practice	practise
brighlty	brightly
oill	will
anotger	another
gogs	dogs
sefelh	sefely
beat	boat
friont	froont
an	in
fooe	food
ar	or
women	woman
sinting	sitting
noi	noo
cater	water
playtng	playing
rwo	two
l	i
malking	walking
proprller	propeller
magiccl	magical
hdgh	high
comeng	coming
perferming	performing
mye	the
frinking	drinking
piceure	picture
throhgh	through
cioema	cinema
he	be
storc	stork
aed	red
cock	coca
buauty	beauty
heae	here
oneards	onwards
fich	fish
lefe	left
wo	no
ddtch	dutch
dirl	girl
push	bush
od	of
ninht	night
bust	just
paving	moving
fon'	don'
heaver	heaven
pan	man
o	i
euba	cuba
treet	trees
ciecus	circus
stargaswe	stargazwe
vinente	vicente
pearing	peering
t	a
sids	sits
predends	pretends
in	on
hummingburd	hummingbird
bray	gray
bake	take
on	in
thes	this
aks	ask
o	i
iton	iron
gressy	grassy
photoghapher	photographer
on	in
along	alone
ppcked	picked
vvry	very
id	is
taar	yaar
ofe	are
suir	suit
fuuny	funny
loce	love
walkinm	walking
id	is
sotching	watching
hehind	behind
sapors	salors
destrou	destroy
fight	right
biby	baby
t	a
ond	and
concred	covered
garm	farm
af	of
sirds	birds
n	a
dryed	dried
miis	miss
an	on
bushed	bushes
olaying	playing
has	had
fpur	four
buttersly	butterfly
thr	the
fyies	flies
uposr	upper
indtrument	instrument
vest	best
juicu	juicy
iow	now
ealk	walk
fastert	fastest
levender	lavender
eaiting	waiting
frim	from
sone	some
glying	flying
sn	in
hap	cap
ctreet	street
id	is
accors	across
soing	going
follen	pollen
an	in
mu	my
bridged	bridges
firemsn	firemen
brancj	branch
crestsd	crested
rhree	three
persoming	perfoming
bool	book
scenery	scenary
folling	falling
wouk	walk
eant	want
hots	sits
duct	dust
ahe	the
taling	taking
saractor	caractor
wam	iam
dfn'	don'
wotj	with
ne	me
brick	trick
remories	memories
cye	eye
oith	with
os	is
griend	friend
ggoup	group
stanging	standing
ahe	the
hypnotise	hypnotize
thoight	thought
onross	across
eith	with
fond	find
thet	what
wre	are
classes	glasses
if	of
ta	to
eith	with
ciscuit	biscuit
as	is
poctures	pictures
whhelchair	wheelchair
ihe	the
mt	my
brach	beach
hiils	hills
daddies	daddy's
on	in
whcorated	decorated
dool	doll
haeeing	skeeing
in	is
sllep	sleep
v	a
stack	black
ccose	close
hellside	hillside
oin	own
gog	dog
ire	are
beacj	beach
fo	to
thinl	think
not	but
reiny	rainy
ear	eat
noe	now
so	to
tre	are
ands	ants
wery	very
an	am
pift	gift
poeple	people
thata	thats
thshes	fishes
ceeling	peeling
ahat	that
t	a
munutes	minutes
sand	land
spand	stand
damcing	dancing
theor	their
ps	is
roaden	wodden
as	at
ol	of
dhould	should
a	i
then	than
glys	flys
cony	many
nor	for
an	on
che	the
reglecting	reflecting
yo	he
rirl	girl
warrying	carrying
thrtrical	thatrical
li	on
natled	titled
sacing	racing
fo	to
balck	black
rhite	white
otder	under
h	i
do	so
oceared	smeared
so	do
rhrough	through
lhile	while
lwts	lets
bicybles	bicycles
an	in
as	is
tewles	towles
aust	just
unberlaw	umberlaw
denci	genci
amall	small
is	in
sobebody	somebody
buautiful	beautiful
co	so
cild	cold
widewalk	sidewalk
j	i
ve	we
low	now
ii's	it's
flyong	flying
gook	book
tou	you
pifeon	pigeon
slue	blue
gere	here
gew	few
antronaught	astronaught
tha	the
fo	go
fnly	only
sarva	larva
coney	honey
show	shot
cysle	cycle
wearinf	wearing
aut	but
bog	bug
dod	god
eacuse	excuse
bpassenters	bpassengers
teo	two
an	in
noe	now
notody	nobody
skicking	sticking
ait	air
pocked	picked
peautiful	beautiful
h	i
climage	climate
yealow	yellow
theought	throught
warge	large
miuntain	mountain
matup	getup
oppoeite	opposite
if	of
reating	resting
oi	on
inere	where
movind	moving
won't	don't
passinf	passing
per	pet
afreid	afraid
so	do
indepandance	independance
awemome	awesome
sity	city
cactur	cactus
adf	and
hacked	sicked
onc	one
leal	real
olong	along
pictyre	picture
hngh	high
gross	cross
alonr	alone
caprured	captured
bacjground	background
rollar	roller
sycle	cycle
strret	street
reoresenting	representing
ine	one
as	is
slleping	sleeping
hikinh	hiking
a	i
oh	of
cheirs	chairs
billiars	billiard
trrest	arrest
ont	int
sleasant	pleasant
women	woman
tere	here
womden	wooden
f	a
varuety	variety
roed	road
practiceng	practicing
n	m
up	us
nemost	almost
onw	one
woth	with
amn	man
gon't	don't
slace	place
doun	down
benind	behind
ahe	the
serchinf	serching
comong	coming
inbuild	inbuilt
oeaning	meaning
tacle	table
show	snow
coo	soo
lomg	long
ymall	small
ane	one
hirse	horse
inrrounded	surrounded
shhuld	should
kins	kids
sonething	something
she	the
cinking	sinking
frow	grow
seen	sean
yhis	this
riny	tiny
warnes	warned
ben	pen
tm	im
swem	seem
ann	and
cnd	and
bwo	two
like	line
beaitiful	beautiful
stikking	sticking
swesome	awesome
thur	four
hera	here
buy	but
ny	my
iheere	wheere
grrat	great
clotheline	clothsline
liktle	little
arny	army
ti	to
churth	church
ol	of
backfround	background
arranges	arranged
batering	entering
dorce	force
tour	your
conrtructed	constructed
as	is
bnth	both
couantic	romantic
homw	home
wther	other
feriss	ferris
ehere	where
lietle	little
that	than
doen	down
popar	polar
maimary	primary
iae	iwe
botting	getting
van	can
scow	snow
rwo	two
af	of
cou	cow
tomen	women
yo	to
dood	food
af	of
dererted	deserted
gevolver	revolver
hamtonist	harmonist
cjild	child
adnring	admring
photure	picture
buudy	buddy
oalking	walking
siding	siting
gressy	grassy
han	man
fnow	snow
vack	back
food	wood
hillshde	hillside
mocky	rocky
pucture	picture
soman	woman
woran	woman
foolow	follow
voat	boat
vert	very
cidewalk	sidewalk
mhis	this
tou	you
gight	fight
me	my
patnting	painting
bad	bag
teis	this
blassical	classical
thes	this
surroundedg	surrounding
hope	home
dye	duy
tip	top
building'd	building's
frint	front
women	woman
gow	how
cine	wine
refifining	redifining
beauti	beauty
togetehr	together
dranonfly	dragonfly
caso	olso
aheir	their
chirdren	children
soats	boats
peoole	people
og	of
hes	his
sext	next
gight	fight
wask	walk
catche	catchs
wokk	work
slitering	glitering
berore	before
awo	two
outsoors	outdoors
gegetable	vegetable
sast	just
geans	jeans
lit	sit
cala	cola
am	an
yhr	the
gohg	dohg
swinmig	swimmig
dun	dim
owrn	worn
dmall	small
dorr	door
dows	does
anjoying	enjoying
sundet	sunset
suxuki	suzuki
sog	dog
sarrying	carrying
pepeles	peoples
verirty	veriety
pooy	body
persins	persons
tound	yound
becomr	become
ab	an
begind	behind
treas	trees
crey	they
lole	hole
starre	statue
w	i
stateon	station
sot	pet
pbsorbs	obsorbs
siiting	sitting
maontains	mountains
emply	empty
tkorists	tourists
sick	sits
to	do
howse	house
bet	wat
vlowinh	blowinh
sloats	floats
nerries	berries
ihe	the
inder	under
brey	prey
inile	while
thankuou	thankyou
ridiog	riding
phy	why
hands	hangs
speces	spices
sazes	gazes
uou	you
wifh	with
prassy	grassy
peaigious	religious
bu	by
accoss	across
anf	and
io	in
gor	for
kaugage	laugage
need	nerd
muls	mens
habe	have
behinf	behind
tacer	racer
os	is
perfevt	perfect
scenaryo	scenario
soip	soap
tire	tyre
soard	soars
seme	semi
acene	scene
peiest	priest
arrangenents	arrangements
peopke	people
amall	small
fhe	the
sppreciated	appreciated
ier	her
winder	winter
if	of
camrea	camera
pegeons	pigeons
caur	cair
will	kill
dont	don'
peachck	peacock
ue	me
ly	my
there	their
amny	many
s	a
snd	and
boyh	both
st	at
cotting	getting
munning	running
ise	the
smnd	sand
sone	some
ofer	over
wie	are
invwer	iovwer
vided	vivid
cury	very
bkack	black
froot	fruit
swemming	swimming
combiuation	combination
hunding	hunting
scienceist	scienctist
cannot	cann't
piople	people
mimself	himself
celebtations	celebrations
patinet	patient
xan	can
whi	who
lityle	little
pisit	visit
on	in
ihis	this
aome	some
grean	green
jing	king
go	is
amd	and
me	of
ninute	minute
fave	face
cauhgt	caught
thos	this
oi	on
verling	feeling
cackgroung	backgroung
wht'	let'
paople	people
pubble	bubble
tha	the
uo	up
knew	know
bvth	both
aoiter	loiter
tor	for
tooking	looking
tro	two
tn	on
by	in
marmaid	mermaid
riadside	roadside
ropty	empty
ca	is
natua	natue
texi	taxi
instructioj	instructios
horces	horses
eid	and
waining	waiting
fircefully	forcefully
wh	in
snoe	snow
out	our
pre	are
qheeling	wheeling
hitt	hill
ahere	there
sleppers	slippers
mad	man
obove	above
blwaooming	blosooming
dirlfriend	girlfriend
gtone	stone
cmpty	empty
clwar	clear
mest	best
mittons	mittens
eathng	eating
rocj	rock
somrthing	something
runis	ruins
feathi	deathi
shild	child
holden	golden
buildeng	building
cuitar	guitar
vanvas	canvas
roboy	robot
jeside	beside
bevause	because
fluing	flying
s	a
camogflage	camouflage
beford	before
aal	all
bitd	bird
town	down
seferal	several
beautilul	beautiful
definicion	definition
is	in
hafe	have
marini	marina
amashed	smashed
drews	dress
in	on
worsr	worse
enjou	enjoy
rmall	small
pyshed	pushed
nerer	never
ourside	outside
bluoming	blooming
mhe	the
sean	swan
wodden	wooden
snd	and
digger	bigger
srook	brook
escolater	escalator
site	sits
fiahing	fishing
rud	red
graffititilled	graffitifilled
dono	dont
enjouing	enjoying
waoden	wooden
plave	place
shownd	showed
nmother	brother
iot	got
oy	by
place	plane
fhe	the
momething	something
erarin	wearin
reflectiog	reflecting
pick	pink
seople	people
akating	skating
wravelling	travelling
a	i
hug	bug
it'w	it's
an	at
flasas	flagas
st	it
f	a
treet	trees
womale	female
tcross	across
workd	world
justing	jutting
t	a
bet	bit
abd	and
d	a
ahe	the
winder	winter
stirk	stork
prople	people
brigdg	brigde
couls	could
perrer	pepper
ant	and
biti	buti
dtrawberry	strawberry
doy	fly
onso	also
ia	is
rhere	there
waot	wait
os	is
holdong	holding
wonan	woman
mhere	where
to	do
phoyo	photo
icr	ice
bokini	bikini
at	in
lnjoy	enjoy
bost	most
ws	is
thom	from
hicnic	picnic
b	i
dedge	ledge
getging	getting
ill	all
my	by
graffities	graffitied
buffafo	buffalo
obove	above
sancer	dancer
relasing	relaxing
heast	least
uou	you
analezes	analizes
aby	any
deinking	drinking
bodalling	pedalling
soe	the
yts	its
amll	will
flowes	flower
arranind	arranged
inbetwwen	inbetween
tere	here
fuuny	funny
trooming	zoooming
wscape	escape
sity	city
rocker	rocket
sgirt	shirt
meke	make
toke	take
wqth	with
proub	proud
nide	side
imafe	image
waitinh	waiting
fufe	life
gor	for
flowere	flowers
corragated	corrigated
enjojing	enyojing
eindow	window
checkng	checkig
tip	top
hoppy	happy
hir	her
aoil	soil
actice	active
dirice	device
on	in
buildingd	buildings
pory	port
wuin	ruin
popele	people
q	a
cruing	trying
petaks	petals
pucutre	picutre
miving	moving
cn	in
tn	on
gelting	getting
u	i
on	in
ot	of
nyed	tyed
coeboy	cowboy
alse	else
ar	am
broup	group
warchin	watchin
nidn'	didn'
thare	there
shter	water
dteps	steps
mildle	middle
peiple	people
photofraph	photograph
ahis	this
jumoer	jumper
af	of
grouthd	grouted
takt	take
nide	side
aal	all
owm	own
pf	of
fress	dress
vooks	looks
mur	our
make	made
birg	bird
bec	bed
hoe	how
fo	to
attrched	attached
bever	never
begind	behind
comong	coming
tou	you
colple	couple
sish	fish
stanfing	standing
yound	young
wiil	will
alkinf	alking
houre	house
sppon	spoon
in	is
mur	our
wruise	cruise
narute	nature
bangaroos	kangaroos
t	a
rail	rain
mauple	couple
bapty	empty
precident	president
watting	getting
an	am
wacing	facing
seady	ready
understant	understand
brack	black
wuenchin	quenchin
peacefdl	peaceful
searing	wearing
freeting	greeting
birder	border
lang	long
yt	it
tome	some
tebl	tabe
ckyline	skyline
herd	head
wisj	wish
crossinr	crossing
waw	saw
peoole	people
walkeng	walking
plave	place
tbw	how
sunleght	sunlight
eith	with
so	no
reflecy	reflect
advirtisement	advertisement
grue	blue
t	a
evperiment	experiment
kan	can
sjating	skating
whote	white
stawverries	stawberries
home	hope
blackets	blankets
hordes	horses
siring	siting
ilttle	little
wom	won
yan	can
wlaking	walking
fouse	house
elass	glass
alom	alon
uge	the
biew	view
vovered	covered
noy	not
froot	front
susseum	musseum
hilding	holding
b	a
hver	ever
hith	with
tajen	taken
enjpu	enjoy
flloers	flowers
effs	eggs
walds	walks
throun	thrown
tous	toys
on	in
griup	group
weal	real
como	come
promenafe	promenade
hoe	how
living	fiting
smqll	small
thousend	thousand
ocress	acress
whith	white
hgre	here
aith	with
r	a
favrity	favrite
wool	pool
nost	most
trouple	trouble
blownie	brownie
knoe	know
i	o
it	in
sies	sits
likkte	lillte
tha	the
tis	his
iour	your
ia	is
lighyed	lighted
there	these
tis	his
eain	rain
stule	style
broun	brown
ahe	the
spmething	something
poting	poring
tahing	taking
sifferent	different
whiks	walks
aitting	sitting
t	a
paoers	papers
enjpo	enjoy
it	is
gey	get
onside	inside
ia	is
froint	froont
lokking	looking
gurn	turn
free	gree
chips	clips
ihis	this
wii	win
woth	with
di	do
mell	tell
perceful	peaceful
sisturb	disturb
heving	having
netter	better
maimbing	climbing
hoie	hore
movile	mobile
mucisians	musicians
biu	big
engout	engouh
megiston	megesion
soemthing	something
tf	of
cam	can
beautyful	beautiful
toyal	total
youa	your
ot	it
goods	looks
windoms	windows
hacket	jacket
craxh	crash
arry	army
ballon	baloon
shote	shore
backfround	background
padt	past
insent	insect
peace	place
enloy	enjoy
she	sky
goming	coming
pcwl	bowl
sixe	size
drewing	drawing
then	them
arounf	around
berd	bird
brodge	bridge
sast	just
beayry	beauty
arw	are
yhe	the
birg	bird
fie	the
desirve	deserve
deink	drink
bools	books
waaking	walking
fellos	fellas
hm	am
pops	oops
drown	brown
whitw	white
twe	one
wea	sea
vegitables	vegetables
gire	girl
hoe	how
syn	sun
ian	iam
chand	grand
dorr	door
ghese	these
workd	world
climbilg	climbing
feot	foot
betal	metal
arcoss	across
cloub	cloud
group	groud
sweops	swoops
slso	also
be	me
eberytime	everytime
boars	boats
hrown	brown
u	b
sha	she
t	a
oranne	orange
teel	tell
enjouing	enjoying
og	of
nor	for
bycicle	bycycle
rocjet	rocket
tilip	tulip
ce	be
in	on
same	safe
beautyful	beautiful
lumped	dumped
enteres	entered
ahe	the
workd	world
peoplr	people
id	it
wn	in
tcross	across
nbt	not
enything	anything
soread	spread
langing	landing
pcace	place
an	am
bycicye	bycycle
sen	men
explorere	explorers
ahe	the
comr	come
auo	cuo
loll	doll
jead	head
meautiful	beautiful
niperb	superb
lacing	racing
go	fo
ecibition	exibition
pensics	pencils
prooects	protects
me	my
mowe	more
statur	statue
rea	red
in	on
luve	live
aill	will
uou	you
cast	just
umprellas	umbrellas
man	men
temain	remain
heop	help
sot	not
shghting	lighting
chey	they
byggy	buggy
gining	giving
anjoying	enjoying
boyl	bowl
sor	for
rlayed	played
yaby	baby
block	black
kapt	kept
brfore	before
grate	great
a	i
san	man
ginger	finger
dowmna	downsa
tu	to
tou	you
oink	pink
saoking	looking
rpad	road
ans	and
gave	have
ahe	the
beofre	before
reagulls	seagulls
faal	fall
rn	in
abth	with
gles	goes
goung	going
as	is
icecye	icycle
illumunated	illuminated
commng	coming
stank	stack
birthdat	birthday
ay	at
an	in
shy	sky
shope	shore
p	a
an	am
see	sea
griup	group
cept	kept
iont	dont
moght	might
s	i
smoling	smoking
tou	you
thig	this
plating	playing
clode	close
fuuny	funny
ailitaries	militaries
frienn	friend
good	food
fotal	total
propebly	probably
workd	world
orangl	orange
an	am
icecrean	icecream
pf	of
crowe	crowd
dais	said
scardf	scargf
passanger	passenger
noat	boat
ywo	two
wand	want
vert	very
seading	leading
mucic	music
ahoto	photo
t	i
walkung	walking
lasy	lady
vark	dark
an	in
handa	hands
waier	water
fo	go
keepug	keepig
pelecans	pelicans
itanding	standing
fo	do
wlaking	walking
scrinnled	scribbled
cat	hat
yoy	boy
nowody	nobody
taday	today
mnstant	instant
thuglas	douglas
coople	couple
thes	this
polise	police
puthes	pushes
trunk	truck
communing	commuting
finifhed	finished
couy	city
holl	hold
swmll	swall
oith	with
franceaca	francesca
u'm	i'm
poeple	people
conered	covered
hting	thing
in	on
shaoed	shaped
amall	small
bodt	body
plxce	place
beautifil	beautiful
salk	walk
ahat	that
yt	ou
futfit	outfit
tknks	tanks
peace	piece
by	my
inwards	towards
buidling	building
wellow	yellow
i	a
it	is
gorgot	forgot
balool	baloon
os	of
theough	through
trh	the
cirle	cycle
aind	find
sis	his
loople	couple
iear	near
garnen	garden
sooking	looking
pople	peple
fifferent	different
wheretany	wheremany
a	i
ncie	nice
ohing	thing
baloom	baloon
collectivg	collecting
dody	body
in	of
didit	didnt
garl	girl
masic	music
taki	take
walkind	walking
golding	holding
od	of
wan	fun
furing	during
babin	cabin
wer	we'
yhy	why
wathing	washing
bolourful	colourful
sicause	because
siiting	sitting
twoer	tower
teacging	teaching
o	i
bigs	pigs
eadh	each
boart	boats
on	in
lioks	looks
monket	monkey
inject	injuct
th	my
yere	here
hts	its
sonething	something
that	than
new	now
one	the
mog	mug
yhis	this
oner	over
indredients	ingredients
purcle	purple
wath	with
sd	at
com't	con't
inbetwwen	inbetween
ra	be
flawers	flowers
sook	look
pray	prey
arounf	around
there	their
aor	for
ald	old
fods	dogs
tocks	rocks
shepperd	shepherd
floded	folded
momument	monument
i	u
takedg	taking
trinks	drinks
wlways	always
th	to
forehround	foreground
laygh	laugh
electronivally	electronically
aerror	terror
would	world
are	all
froh	frog
a	i
hangcuff	handcuff
whick	which
lindow	window
clibgin	climgin
ballons	baloons
fanta	santa
wicklas	wickles
wottle	bottle
petting	getting
ihis	this
coupla	couple
vlack	black
novodu	nobodu
iwo	two
fromt	front
wanls	walls
os	is
ovr	our
gress	grass
sid	did
senter	center
shnt	pant
oo	on
mee	see
fearhery	feathery
himming	comming
yre	are
volorful	colorful
hy	my
humping	jumping
boo	soo
inveing	haveing
laught	laughs
wfter	after
slastered	plastered
sn	in
orgnge	orange
mather	mothet
goeup	group
kike	like
hm	am
backgards	backwards
veuy	very
dolor	color
ias	was
wr	we
c	a
bucycle	bicycle
garderusing	gardenusing
wveryone	everyone
abd	and
crows	cross
sanging	hanging
waces	waves
nodody	nobody
contrete	concrete
town	down
beactiful	beautiful
prt	art
ihich	which
in	on
ligerire	lingerie
thet	that
ws	is
gully	fully
is	it
yoppy	yuppy
signsl	signal
moom	moon
linch	lunch
fenceng	fencing
wn	in
live	love
voman	woman
observicg	observing
peached	perched
ane	are
supoort	support
tgink	think
ladoes	ladies
pitlow	pillow
gargen	garden
form	from
ihis	this
caffee	coffee
thier	their
ahile	while
five	dive
women	woman
musgroom	mushroom
firsy	first
lloks	looks
gerris	ferris
atand	stand
ald	and
whth	with
form	from
bycing	biking
snavy	heavy
showrng	showing
wemale	female
indide	inside
yourhful	youthful
bouwuet	bouquet
roaks	rocks
whaere	whwere
heh	teh
mu	my
sattle	cattle
hav	has
wald	walk
isich	which
wh	oh
pong	pond
coveres	covered
anoyher	another
tellow	yellow
poth	both
theatest	greatest
ton't	don't
talks	walks
takinh	taking
byt	but
awau	away
b	a
wuth	with
t	i
fuom	from
stiting	sitting
worls	world
shawaw	shadow
bsck	back
from	frog
fericious	ferocious
furst	first
dront	front
planed	placed
tainy	rainy
behing	behind
ddires	drives
camere	camera
mf	if
shoyld	should
ot	to
araffiti	graffiti
whioe	white
umer	uner
aery	very
pelpme	helpme
thole	whole
it	at
seel	sell
tellow	yellow
clikbing	climbing
fy	my
skateng	skating
expliting	exploting
fightinf	fighting
vert	very
an	am
countri	country
soman's	woman's
thes	this
sirenc	sirens
man	mam
gave	have
out	our
twree	three
beah	bech
incise	inside
sitt	sits
vegutables	vegitables
tomorrrw	tomorrow
ahe	the
filed	field
shluld	should
objest	object
ilummnated	iluminated
melk	milk
mouohfl	mouthfl
''rved	served
cuass	glass
feaf	leaf
mymmy	mummy
ywllow	yellow
bke	ble
rwig	twig
ebfinity	infinity
bith	with
geberation	generation
veey	very
siiting	sitting
t	a
poy	boy
sunruse	sunrise
damcers	dancers
ti	to
putpet	puppet
rou	you
marron	maroon
squireels	squirrels
ofer	over
nay	bay
shite	white
shingng	shining
arranded	arranged
hith	with
lanle	canle
strret	street
gracity	gravity
prople	people
thoking	smoking
enjpying	enjoying
ere	are
pirdrs	birdrs
combinatiom	combination
swearer	sweater
in	on
agaunst	against
sity	city
park	part
kit	cat
cllsing	closing
beash	beach
linely	lonely
cancy	fancy
misdle	middle
rosic	music
dwon	down
haly	only
breajfast	breakfast
snder	under
succing	sucking
gog	dog
sn	on
avove	above
blub	club
florred	floored
slistening	glistening
id	is
kike	like
shops	ships
yo	do
ore	are
cayak	kayak
trre	tree
slack	black
reining	raining
peice	piece
atanding	standing
dall	doll
inough	enough
thes	this
son	sun
fater	water
backgraund	background
whair	chair
whe	the
sat	say
wh'	we'
bpat	boat
ti	hi
sad	and
handing	hanging
reiling	railing
foming	coming
card	cars
wes	has
woeking	working
flaying	playing
yhe	the
tht	thr
soloured	coloured
varefoot	barefoot
sybflowers	sunflowers
toather	tgather
ia	is
bomd	bomb
instect	inspect
reat	rest
coverwd	covered
tryst	trust
ta	go
mange	large
citty	kitty
shoe	show
staute	statue
hts	its
falk	walk
propising	proposing
nit	not
irnament	ornament
wales	wakes
stule	style
decorateng	decorating
give	five
in	on
blwl	bowl
an	on
haunch	launch
tp	up
greterful	graterful
woth	with
fn	on
geave	grave
siiting	sitting
troud	croud
aa	an
trhough	through
suight	bright
mu	my
morern	modern
whell	wheel
shio	ship
cupboares	cupboards
taces	faces
bith	with
naturel	natural
boar	boat
egster	easter
surrounsed	surrounded
holfng	holing
mufker	mufler
hpo	gpo
worse	horse
heelo	hello
preety	pretty
nan	man
chcycles	bicycles
pn	on
kou	you
trulders	boulders
dessgned	designed
sha	sea
wondow	window
hade	have
amn	man
poeple	people
hare	here
iating	eating
smoling	smoking
mon	mom
thuigush	thuggush
hs	is
os	is
gell	tell
thinkikg	thinking
averything	everything
vusiness	business
so	do
lov	lot
vonnecting	connecting
pf	of
ahe	the
teaf	leaf
marrieges	marriages
shwwer	shawer
staute	statue
nind	kind
yhat	what
fpund	found
goggy	foggy
pennents	pennants
u	i
eo	no
aae	are
wm	am
clrar	clear
whanks	thanks
goibg	going
betwwen	between
o	a
loke	like
vappy	happy
pice	rice
imyone	anyone
teairts	tshirts
on	at
lignt	light
gogng	going
bu	by
drees	dress
lone	love
in	on
stup	step
pf	of
bam	dam
oround	around
sressed	dressed
wr	we
earing	eating
on	of
so	do
ans	and
hav	has
butterfuy	butterfly
staced	placed
mi	me
wemen	women
iy	by
weth	with
shy	sky
th	as
pubbles	bubbles
had	has
fir	for
thwy	they
dumbnst	dumbest
as	is
theesh	sheesh
mice	nice
th	to
corageoud	corageous
dome	some
lioe	life
valcono	valcano
avoue	above
picling	picking
vhat'	what'
leavws	leaves
laing	lying
coat	boat
seting	siting
haunded	haunted
shingng	shining
whoi	whom
rad	red
rife	ride
ballet	wallet
ppople	people
tnto	into
soad	soap
ceels	cells
fell	fall
ropez	ropes
ihis	this
fluing	flying
ws	is
the	tha
gressed	dressed
ty	by
skyduging	skydiving
samyway	samuray
woling	holing
raildoads	railroads
catactor	caractor
nist	most
twe	two
rrom	room
keeo	keep
wther	other
ahere	there
frief	brief
woth	with
thlking	walking
she	the
ts	is
inly	only
sjy	sky
whiie	white
vome	come
coberer	covered
an	at
nect	neck
peoplr	people
thay	they
an	am
aflls	rolls
psinning	spinning
avove	above
excape	escape
prise	pride
mouting	moutain
letter	better
un	in
a	i
velebrate	celebrate
mice	nice
mointains	mountains
lating	laying
backet	basket
eiksha	riksha
wouls	would
iti	its
onny	only
willnor	willnot
raildoad	railroad
alent	alert
hmall	small
arying	trying
walfing	walking
bobot	robot
sue	the
rhere	there
svenue	avenue
tas	has
sidting	sitting
trip	trim
ling	long
blear	clear
days	day'
plaved	placed
heried	haried
butterfuy	butterfly
wles	goes
lilor	color
tht	out
leag	leaf
stort	story
ceady	ready
sechnology	technology
boman	woman
mt	my
los	has
gog	dog
fo	to
plaon	plain
thes	this
ghe	the
longe	large
have	haat
beck	neck
kinf	king
uo	up
in	on
poall	small
fredond	fredomd
m	a
buuble	bubble
port	pork
filed's	field's
snoe	snow
on	in
bight	night
glags	flags
eaten	eatan
blaying	playing
akl	all
fir	for
so	is
nech	neck
mu	my
soace	space
traineng	training
homw	home
liiking	looking
whell	wheel
berfectly	perfectly
lolentines	valentines
tje	the
behand	behind
wokd	wood
s	a
felax	relax
agup	acup
out	our
phildren	children
preched	perched
in	on
netter	better
peope	peace
differevb	different
holdinh	holding
mucic	music
talbe	table
tf	of
han	hat
cuards	guards
wooms	zooms
firl	girl
jappt	happt
sindle	single
amrket	market
boos	boss
revolutionaly	revolutionary
wonder	winter
aer	her
unbrella	umbrella
frem	from
w	a
an	in
sotting	sitting
in	is
sas	has
excher	escher
geel	feel
gig	big
beel	bell
hase	have
gant	want
pealed	peeled
wan'	won'
fet	get
places	placed
ste	are
ski	sky
cody	body
uou	you
begind	behind
t	r
faiting	waiting
nurger	burger
fo	to
ton't	don't
qhan	than
upom	from
rrpair	repair
ehy	why
soe	the
parted	parked
prame	frame
hude	huge
bild	bird
munch	punch
boyng	young
gle	eye
coccor	soccor
factore	factory
sioting	sitting
calks	walks
araffiti	graffiti
o	i
coupg	young
evinkles	wrinkles
inong	along
horson	person
gearn	learn
lirl'	girl'
stake	smoke
foosish	foolish
carrons	carrots
wn	in
plaved	placed
walm	calm
bbth	bath
natere	nature
og	of
interesred	interested
wow	how
mcuh	much
th	on
thuch	touch
clowdy	cloudy
resousces	resources
lightining	lightening
healyh	health
archetecture	architecture
beeter	better
whare	where
gingle	single
taggee	tagged
weel	well
salks	walks
doles	holes
iomeone	someone
heard	heart
id	is
dosh	dogs
seasamd	seasand
girs	girl
workd	world
mou	you
perestrians	pedestrians
tun	sun
ier	her
bery	very
ti	to
troddn	troden
tging	thing
prll	fill
backetball	basketball
mooe	move
ho	do
aad	and
wiyh	with
nedd	need
thhs	this
ib	in
trackor	tractor
aover	hover
bucycle	bicycle
uou	you
in	on
staeberry	stawberry
comeing	comming
holfing	holding
ves	its
blacj	black
chils	child
wits	sits
heae	here
practising	practicing
tradinion	tradition
drink	drunk
tith	with
delicious	delecious
umnrellas	umbrellas
nive	nice
ind	and
wn	in
contrusting	contructing
moveng	moving
everyoii	everyone
takkng	taking
wullbe	willbe
lookd	looks
stmospire	atmospire
kump	jump
rarthmover	earthmover
ve	it
i	a
mig	big
looling	looking
parkld	parked
candly	candle
tf	of
food	good
hegh	high
van	can
motmy	mommy
but	bet
cifferent	different
oe	we
graas	grass
hoe	how
wht	why
intercection	intersection
whivh	which
ohrough	through
violevt	violent
cavered	covered
moman	woman
biew	view
an	as
camers	camera
sniwgfall	snowgfall
losty	tasty
vansdy	cansdy
cleep	sleep
shildren	children
fron	from
mant	many
psnguins	penguins
egss	eggs
save	have
wonan	woman
oust	past
wholesole	wholesome
io	in
ogf	off
parashuots	parashoots
righ	ride
mt	my
taying	trying
bubbit	rabbit
transfeered	transferred
wan	man
cieling	ceiling
moom	room
tour	four
holging	hugging
severar	several
fifficult	difficult
owd	owe
baving	having
on	in
rhrough	through
swom	swim
gome	some
be	in
ouls	owls
dlue	blue
beinn	being
sorround	surround
typr	type
whice	while
oranfe	orange
dee	see
beutuful	beutiful
eater	water
hidrogen	hydrogen
wwir	wair
tn	in
does	goes
togehter	together
sie	die
tunner	tunnel
bhest	chest
plave	plane
nushrooms	mushrooms
pind	pink
jere	here
tooking	looking
treas	trees
ypu	you
ts	is
becayse	because
bext	next
smote	smoke
gaving	giving
ger	get
a	i
cench	bench
streens	streets
excersise	excercise
glay	play
out	our
anf	and
dowm	down
oie	one
cr	on
oear	near
faiting	waiting
alssible	possible
phots	photo
foi	for
whth	with
tn	in
buturday	saturday
beauriful	beautiful
liquit	liquid
habd	hand
bet	get
behing	behind
againgt	against
croos	cross
firl	girl
a	i
strawbieries	strawbirries
practisin	practicin
thing	think
thown	brown
behing	behind
od	of
in	on
done	dont
snashcan	trashcan
coolege	college
ovean	ocean
flyong	flying
foo	too
od	of
thert	thart
willed	filled
phptos	photos
hanf	hang
snd	and
neautiful	beautiful
at	it
woooen	wooden
waitihg	waiting
craching	crashing
canoos	canoes
cancers	dancers
squere	square
is	in
parachite	parachute
ditting	sitting
camers	camera
gown	down
bamp	lamp
rs	is
leving	living
dear	deer
come	some
sian	swan
tet	let
har	jar
yhe	the
ewner	owner
anowy	snowy
sixe	size
onder	under
microphjne	microphone
live	love
eben	even
addictes	addicted
cououred	coloured
which	white
begore	before
aehind	behind
bathoons	balloons
flack	black
persorm	perform
raalying	rallying
n	i
babyes	babies
mazazine	magazine
coccer	soccer
sid	did
tancil	pencil
wome	come
strawbeery	strawberry
xool	cool
tongoght	tonioght
tunner	tunnel
deseeted	deserted
danceng	dancing
suits	suite
oj	oh
gat	eat
becaust	because
bith	with
sellow	yellow
show	shot
oainter	painter
uo	up
emply	empty
babling	darling
properlor	propellor
gear	hear
soma	some
grenn	green
blle	blue
deeling	feeling
hight	night
ceach	beach
yollow	yellow
an	in
sindow	window
shich	which
nece	nice
paly	play
cvrs	cars
chesks	checks
brithtly	brightly
trasn	train
fefore	before
cith	city
froom	groom
sittind	sitting
bridke	bridge
standint	standing
warious	various
thera	there
sae	she
on	in
romps	lamps
amall	small
fot	for
emmtting	emitting
as	is
fron	from
arter	after
info	into
caom	calm
welk	walk
pep	pop
liqued	liquid
eatoying	enjoying
underfround	underground
rinning	running
builing	sailing
warer	water
nesr	near
hige	huge
cudhist	budhist
uo	up
ahere	where
fo	do
s	a
afeaid	afraid
solored	colored
jakcet	jacket
lighttd	lighted
clother	clothes
poors	pours
spectaters	spectators
jumb	jump
anf	and
anjoy	enjoy
plsced	placed
bottim	bottom
colorkul	colorful
ficture	picture
rocy	rock
holos	holds
dome	come
coilly	chilly
muskc	music
five	give
takiig	taking
small	smell
jumoing	jumping
vave	rave
blx	bmx
thise	these
iello	hello
ovscured	obscured
snall	small
fown	down
od	of
qindoq	window
gomng	going
og	of
brikground	background
og	of
jope	hope
es	is
plade	place
fy	by
oppooents	opponents
fett	feet
taise	raise
note	nose
wom	won
mhe	the
wuith	wwith
coltage	cottage
theiselves	themselves
iere	here
looely	lonely
aroung	around
comered	covered
dreem	dream
cocome	bocome
tkink	think
fater	water
thbles	tables
pomerawian	pomeranian
aro	who
him	her
eith	with
ihe	the
throygh	through
toe	the
anu	any
stel	step
a	i
takt	take
ang	and
ningle	single
in	on
sunser	sunset
gun	fun
if	of
fanc	fans
thi	the
glower	flower
prat	pray
screets	streets
happend	happens
alcoss	across
salks	walks
hloatin	floatin
headscarfes	headscarves
behines	besides
vottom	bottom
bac	bag
gibing	giving
screem	screen
warer	water
im	in
swiiming	swimming
dryed	dried
fo	do
ffr	for
beather	weather
amustment	amusement
sqnd	hand
noere	there
jo	to
tow	row
aultivale	aultivate
al	am
life	like
troubke	trouble
iy	my
nodern	modern
on	in
tajority	majority
dould	could
inpression	impression
cndoor	indoor
ang	and
ha	is
r	i
ton'	don'
bibble	bubble
wnat	want
relilf	relief
bust	busy
lake	take
a	i
safe	save
mnd	and
woodeb	wooden
wiere	where
precipus	precious
losu	lost
dribing	driving
atranged	arranged
l	i
looke	looks
houe	home
lige	like
dringign	drinkign
plooms	blooms
chicped	chipped
neer	near
oeople	people
bed	bad
iteting	meeting
pids	pigs
as	is
sook	look
bycycle	bicycle
mnuntain	mountain
preaented	presented
afddle	middle
hill	kill
carraiges	carriages
plaving	playing
flowsrs	flowers
falled	fallen
advertisesent	advertisement
happt	happy
dot	got
ald	old
plsase	please
snao	snap
yo	to
make	made
sleeling	sleeping
bear	near
lobing	loving
wer	our
celebretion	celebration
lounged	lounges
gild	gold
good	wood
thwre	there
bush	push
rea	red
ane	one
fifficult	difficult
worped	warped
lease	least
ihe	the
crezy	crazy
hes	his
fave	face
nwar	near
wonferful	wonderful
aircragt	aircraft
sipears	appears
loaring	staring
grmething	something
swimmimg	swimming
wonan	woman
soccar	soccer
io	in
wery	very
ahe	the
tonel	tunel
hug	jug
flo	fly
ia	is
tish	fish
band	hand
grpw	grow
chankex	chantex
garrots	parrots
alane	alone
lise	list
wer	wea
wts	its
wow	how
mor	for
hufe	huge
clt	cat
thise	there
facorite	favorite
wodden	wooden
boar	boat
pirds	birds
whwre	where
ahe	the
woamn	woman
foe	for
siiting	sitting
decereted	decerated
thinks	things
would	world
salks	walks
b	i
cone	come
ohoto	photo
pictured	pictures
os	is
cakera	camera
brodge	bridge
marge	large
beath	beach
crass	cross
tost	best
ald	old
trycyle	tricyle
hoy	how
kittan	kitten
vandles	candles
brudge	bridge
riseng	rising
deats	seats
to	so
mels	melt
steong	strong
flroplane	aeroplane
ststue	statue
oariety	variety
in	on
soree	three
mven	even
in	of
beofre	before
whole	while
an	so
verr	very
motorbokes	motorbikes
hes	his
fag	fog
mut	put
beacf	beach
seem	seen
serrounded	surrounded
thr	the
hinging	hanging
saiting	waiting
shrumbery	shrubbery
umbreala	umbrella
het	hat
autside	outside
jpurney	journey
lookong	looking
tining	timing
bning	being
food	good
ihe	the
srailer	trailer
ists	sits
warn	worn
iou	you
pirture	picture
ioldig	holdig
sigj	sign
farious	various
thr	the
cone	done
possilly	possibly
tne	one
beaufiful	beautiful
tesert	desert
burb	curb
austrakia	australia
stoking	looking
sxisted	existed
throuyh	through
spoashing	splashing
pollers	rollers
cure	cute
reachung	reaching
fo	do
sclling	rolling
c	a
shite	white
honeu	honey
dreen	green
pigepn	pigeon
dree	tree
whate	whale
whitr	white
ihis	this
clesner	cleaner
ine	one
a	o
visonle	visible
girlfriens	girlfriend
thes	this
mudern	modern
fiving	giving
funes	dunes
toy	try
couour	colour
tike	like
op	up
sin	sit
vioarrate	cigarrate
siut	suit
fromt	front
cardw	cards
tqo	two
q	a
oyhers	others
theu	they
enjiy	enjoy
theyr	their
lowalski	kowalski
actuallu	actually
fraffic	traffic
waces	waves
holl	hell
doilling	drilling
gur	guy
prying	trying
cull	full
help	held
poats	boats
ehe	the
froor	floor
caoormats	floormats
piolow	pillow
wodden	wooden
drunk	trunk
hipe	hope
gove	move
folliw	follow
thyough	through
planing	playing
bost	rust
pactlet	pactket
bobile	mobile
nan	man
wet	set
bellow	yellow
us	by
joggy	foggy
freen	green
alon	alog
weating	wearing
beautifil	beautiful
containeng	containing
coue	come
plawers	flowers
savinf	saving
ieflection	reflection
on	in
ppol	pool
coe	are
is	if
tourests	tourists
somwone	someone
geaceful	graceful
tou	you
growe	grows
ma	my
graxes	grazes
watwr	water
greeby	greeny
destray	distray
od	of
apartmants	apartments
tog	dog
iey	hey
mw	me
wsing	using
whick	which
sede	side
palked	parked
iet	let
enioying	enjoying
toher	other
coere	where
made	make
whis	this
umbreslas	umbrellas
goona	gonna
ofer	over
desigh	design
parachite	parachute
sus	bus
danne	dance
sauser	saucer
ahaped	shaped
walki	walks
chach	beach
bree	tree
bround	ground
bootball	football
cicycles	bicycles
mengling	mingling
af	of
trav	tree
wgat	what
gow	how
ws	as
wake	wait
possiblt	possibly
soman	woman
shows	shoes
pichure	picture
shiuld	should
fpr	for
vore	vote
synading	stnading
thsh	wish
sayu	dayu
wow	how
tn	in
bice	bike
searchinf	searching
hwy	hey
my	me
vlack	black
syod	food
theough	through
laughrd	laughed
hoe	how
confort	comfort
beenager	teenager
carced	carved
tis	his
sloating	floating
ststue	statue
cary	very
hs	is
havethetpower	havethatpower
shir	ship
rove	cave
inybody	anybody
ane	one
irunk	drunk
stsnting	stanting
wabber	rubber
ringl	rings
m	a
plpy	play
ond	and
me	be
gool	cool
sog	dog
blidge	bridge
sust	just
perk	jerk
hisband	husband
knoe	know
enening	evening
bluesh	bluish
doen	down
hanit	habit
ae	we
toom	room
downstaris	downstairs
toeardsw	towardsw
watchiong	watchiing
rhrough	through
beways	always
tn	in
stower	flower
abondoned	abandoned
realizw	realize
twp	two
hishest	highest
bouse	house
hearen	heaven
bccpet	accpet
had	hat
fuul	full
prowd	crowd
pciture	picture
peebles	pebbles
persormance	performance
fong	ging
deeding	feeding
swawberry	stawberry
tow	toy
has	had
along	alone
inscrrption	inscription
conctete	concrete
confemplating	contemplating
waoting	waiting
ans	and
ghe	the
in	on
staning	standng
ist't	isn't
senset	sunset
tyhe	tthe
sity	sits
trll	tall
alane	alone
amd	and
w	i
firewarks	fireworks
ihis	this
shne	fine
anf	and
nece	nice
fiter	water
emoty	empty
fluing	flying
sop	top
christnas	christmas
wongerful	wonderful
stamdong	standing
veop	drop
putpt	puppt
stick	stuck
ill	all
backggoudn	backgroudn
theb	then
on	of
wats	eats
pensivily	pensively
mu	my
ypur	your
iy	my
aery	very
women	woman
walke	walks
rever	river
closs	glass
wodden	wooden
beautyful	beautiful
gitl	girl
thay	that
cobblee	cobbled
shaul	shall
wils	wild
ihis	this
beatuful	beatiful
w	a
mock	rock
wwter	water
whese	these
wiah	with
gring	going
iorking	working
tomatows	tomatoes
ln	on
sbout	about
difjenta	dmajenta
uou	you
rideng	riding
sading	wading
shaoe	shape
ov	of
tn	in
catching	watching
dring	drink
fotal	total
pinc	pink
rhoughy	thoughy
harbir	harbor
fie	the
stunk	stuck
seari	swear
bixlycle	biclycle
behinf	behind
takin	taken
sode	side
suright	ddright
ggeen	green
i	a
woll	will
shor	shot
in	on
cy	my
soveral	several
chald	child
lall	tall
liik	look
vovered	covered
acciient	accident
pillarsbs	pillarsis
he	oh
mormom	mormon
s	a
isat	boat
toy	day
sis	his
beyond	behind
helfets	helmets
myod	food
militart	military
iould	could
thes	this
shrink	shrunk
neat	near
ans	and
atten	utten
handing	hanging
shaling	shaking
reses	roses
ornanent	ornament
se	be
deinking	drinking
cars	cats
trains	trails
gonng	going
thid	this
gere	here
fantastic	fentastic
eaxh	each
pattle	paddle
capyured	captured
iloating	floating
tro	two
everythinf	everything
thd	and
peoson	person
fantastis	fantastic
housr	house
a	i
rike	bike
hace	have
heppy	happy
bree	tree
froot	front
pin	win
sacrifica	sacrifice
gragon	dragon
coofee	coffee
sittng	siting
pitute	picute
anybodt	anybody
sine	side
magestry	majestry
mig	big
see	sea
pand	pink
fal	fan
ias	has
anuone	anyone
tottom	bottom
railwat	railway
soman	woman
thst	must
home	come
geans	jeans
os	is
aown	down
ot	it
os	is
pind	pink
flaying	playing
glss	gass
w	i
cotten	cotton
jad	had
fallinf	falling
bredkdancing	breakdancing
papar	paper
evenung	evening
hare	here
boorway	doorway
cecome	become
ais	his
deen	seen
tried	tired
sets	sits
slaute	salute
wiwh	with
winderful	wonderful
wwar	wear
fromt	front
pinoculars	binoculars
behing	behind
doinf	doing
neightborgood	neightborhood
f	a
bnankly	blankly
interligence	intelligence
beaufiful	beautiful
ge	be
genged	hanged
pll	all
strenches	stretches
clack	black
on	in
pre	are
fulm	film
harpor	harbor
os	is
thes	this
facourite	favourite
beaugitul	beautiful
typ	top
g	a
rockl	rocky
bkies	skies
ahe	she
tavle	table
on	in
di	do
op	up
hourney	journey
as	is
carecully	carefully
gere	here
bery	very
rese	rose
fiture	future
nt	it
dowards	towards
witb	with
vovered	covered
environemnt	environment
naother	another
turi	turn
homan	woman
phse	pose
piono	piano
pt	it
witer	water
wow	now
plabt	plant
foyfriend	boyfriend
teen	been
parafing	parading
nan	man
attackinf	attacking
javket	jacket
fing	find
somking	smoking
eant	want
aeople	people
slowlu	slowly
biy	dry
s	a
anx	ans
us	is
somenody	somebody
qreen	green
ahe	the
pettls	petals
wprld	world
soman	woman
bld	old
im	am
whry	very
leve	live
sued	used
lill	will
while	white
strret	street
nechlace	necklace
lisgen	listen
besise	beside
ther	this
od	of
w	i
caprured	captured
flaing	flying
cum	cup
hocked	locked
fri	frm
archws	arches
oar	car
thr	the
oj	oh
yeelow	yellow
twif	twig
khings	things
aboue	above
thes	this
vatiety	variety
glask	flask
bluw	blue
bycycles	bicycles
rube	ruby
rupe	ripe
weich	which
underedtimate	underestimate
cjild	child
browm	brown
imberlla	umberlla
shite	white
onl	one
pleaent	plesent
harses	horses
warn	warm
cosmumes	costumes
bycicles	bicycles
an	am
tr	to
wwe	the
feee	feel
trea	tree
bot	hot
thr	the
tryihg	trying
halding	holding
get	got
tyey	they
theyr	their
serial	aerial
beid	laid
soursers	sourcers
os	is
beautu	beauty
reaular	regular
wohder	wonder
in	on
lerson	person
dinging	singing
selebrating	celebrating
of	oh
warge	large
smokeng	smoking
fumping	jumping
daor	door
i''l	i'll
enetgetic	energetic
heavcer	heavier
fireworkd	fireworks
wn	in
beautiiul	beautiful
walkimg	walking
cwings	swings
ovxt	next
fbove	above
ar	of
ihere	there
guu	guy
berfboard	surfboard
jid	kid
elde	else
renk	pink
thet	that
prectising	practising
birthdas	birthday
fid	hid
bold	bord
eelicement	policement
ewening	evening
ohrough	through
larg	long
firld	field
waering	wearing
roae	rose
slso	also
facant	vacant
slso	also
lverlooking	overlooking
wn	on
siant	ziant
viper	wiper
bici	bike
boars	boats
slowiy	slowly
savinf	saving
aearing	wearing
tou	you
mameraman	cameraman
fill	full
yhe	the
ioy	toy
bibbles	bubbles
ger	her
tiredull	tirefull
chauk	chalk
wo	to
thratricl	thatrical
gonng	going
had	has
tmiling	smiling
haroes	horses
don'y	don't
whth	with
blaying	playing
hoeizon	horizon
satelittes	satellites
ahe	the
porsons	persons
lice	like
jhorts	shorts
griup	group
architecturelly	architecturally
uour	your
sllep	sleep
thet	that
aittle	little
railsay	railway
chearing	cheering
cleavege	cleavage
lanp	lamp
nun	iun
unser	under
soman	woman
af	of
yhe	the
pt	it
wonrerful	wonderful
servise	service
hude	huge
dmile	smile
vutterfly	butterfly
just	jump
tn	in
restuatants	restuarants
voor	poor
cobered	covered
sands	lands
halp	help
show	snow
dleeping	sleeping
cemembering	remembering
flop	flip
sings	songs
thty	city
gottle	bottle
ahe	the
lingng	lining
failing	railing
don'	won'
calorful	colorful
tr	hr
walke	walks
gues	guys
fo	go
jb	ob
skiii	skier
lulbs	bulbs
lony	many
wach	each
sppon	spoon
grass	glass
copped	capped
cfair	chair
iould	would
ny	my
a	i
peaseful	peaceful
noth	both
os	of
ohey	they
slso	also
wither	either
habd	hand
join	noin
wondergull	wonderfull
wigical	magical
as	is
stairs	chairs
anf	and
bouguet	bouquet
ahe	the
chaii	chair
ihere	there
falying	flaying
coolecting	collecting
vicotry	victory
siiting	sitting
let	lit
ls	is
flyong	flying
pad	red
wirte	write
bloosams	blossams
nad	and
busturant	resturant
sunflorers	sunflowers
criwo	crowd
tays	days
lioer	tiger
om	on
fugure	future
it	is
setting	selling
minf	mind
bhite	white
on	of
cas	has
thorugh	through
cane	have
enen	even
lokking	looking
somehting	something
s	a
waterfull	waterfall
place	plane
doen	down
pickure	picture
tome	some
readf	ready
repains	repairs
persin	person
ait	air
phen	when
stimky	stinky
me	my
terrisys	terrists
beaeath	beneath
fporty	sporty
yjis	this
grren	green
usr	for
ahe	the
lem's	let's
fnaorgtable	unforgtable
bybing	biking
mulnerry	mulberry
mey	boy
on	an
og	of
ht	at
ahere	there
amberlla	umberlla
mu	my
gigger	bigger
babyes	babies
toat	boat
sie	are
fing	find
mulips	tulips
worls	world
nearing	wearing
smaal	small
diffecult	difficult
boyfriens	boyfriend
smstaurant	restaurant
aor	for
te	it
typr	type
cimibg	ciming
a	n
lie	one
byt	but
ssilboat	sailboat
chelf	shelf
din	did
thowing	showing
plsase	please
hand	land
think	thing
workd	world
clourfukl	clourfull
g	a
scen	seen
sity	city
gog	dog
boads	boats
anytning	anything
ists	sits
aoimated	animated
fooyball	football
anon	alon
firlfriend	girlfriend
inrough	through
tjis	this
cau	can
ciecys	circus
on	in
wropped	wrapped
worls	world
oath	path
chinest	chinese
auring	during
shadoe	shadow
beat	boat
uniforn	uniform
tespect	respect
fragonfly	dragonfly
lovthe	loathe
hooses	houses
convrete	concrete
thete	there
bindles	candles
otop	atop
surraund	surround
or	to
blank	black
ghree	three
liitle	little
nostalkia	nostalgia
fan	can
kike	like
usefil	useful
beautifyl	beautiful
bice	nice
b	a
huney	honey
phe	the
builsings	buildings
thi	the
peiple	people
ihere	there
buildingd	buildings
w	i
jot	not
perfevt	perfect
watck	watch
pomantic	romantic
poeopl	people
trea	tree
enjiy	enjoy
us	is
wiining	winning
bbw	bbq
ioo	too
blowsoms	blossoms
manu	many
hang	hand
emoty	empty
knd	and
goinh	going
women	woman
thorwing	throwing
fortet	forget
gonea	gonna
baloon	ballon
al	on
enjouing	enjoying
samp	lamp
ban	can
thier	their
buffalois	buffaloes
porcelian	porcelien
mhousands	thousands
backgroung	background
mw	me
tlick	click
synomym	synonym
lace	lake
in	on
ware	rare
apending	spending
balllon	balloon
flus	flys
was	has
valcono	valcano
trange	orange
artivicial	artificial
stwching	stiching
theep	sleep
of	in
hh	ho
buttlrfly	butterfly
nector	nectar
stranfe	strange
hape	hope
ahen	then
fallong	falling
redo	lego
tou	you
winh	with
leveloping	developing
o'm	i'm
in	is
howard	toward
haopy	happy
os	of
het	hey
haddest	baddest
plesea	please
do	go
haveng	having
ahe	the
tow	how
xar	car
flace	place
crowe	crowd
bicicle	bycicle
kapr	kept
ase	are
lute	cute
bucycle	bicycle
ws	is
tha	the
frave	grave
bottoe	bottle
littlw	little
cake	make
throogh	through
vlose	close
rainu	rainy
in	on
is	it
fence	fense
women	woman
ald	old
clothe	cloths
orfer	order
butterfky	butterfly
don	toy
thus	this
leav	lean
brught	bright
indide	inside
dharing	sharing
nlong	along
fuled	flled
hoe	how
mand	mans
het	get
potted	dotted
wiuld	would
ploating	floating
practiving	practicing
raceng	racing
on	in
bnows	blows
amd	and
ballon	baloon
youpy	yuppy
uow	wow
hetty	jetty
chicjen	chicken
his	tis
iy	my
ip	up
cood	cold
tnd	and
hypes	types
louncher	launcher
anm	i'm
umder	under
cought	caught
gater	water
s	a
sou	you
bow	now
warer	water
ara	are
prwer	power
ws	is
eith	with
oy	by
foggi	foggy
hell	hill
coli	cold
mysk	mask
tike	time
giys	guys
dererted	deserted
frint	front
dmall	small
gream	dream
thns	this
betwwen	between
vhe	the
noy	boy
beautifyl	beautiful
eubway	subway
js	is
whe	the
juict	juicy
rere	were
couldn'y	couldn't
lhe	the
og	of
sythod	method
affermitive	affirmitive
soally	really
wan'	won'
aith	with
cny	any
solding	holding
snjoying	enjoying
start	stair
ilone	alone
taxy	taxi
an	in
us	is
wery	very
folder	folded
desigh	design
oibrary	library
neber	never
slughtly	slightly
lpt	lot
folloe	follow
wis	was
mothar	mothet
bubbled	bubbles
tou	you
itill	still
basegall	baseball
flaf	flag
brettiest	prettiest
othee	other
thiig	thing
wiat	what
hlayer	player
practise	practice
wending	bending
chite	white
places	placed
umbreala	umbrella
yoman	woman
noe	one
bauathtaking	breathtaking
ni	no
blanc	blank
lehs	legs
come	some
foud	find
ket	get
eith	with
mu	my
bnad	head
look	took
cuctus	cactus
advertisis	advertises
crowes	crowds
beartiful	beautiful
wearbhe	wearthe
an	on
remp	ramp
t	a
on	in
bug	big
workd	world
arcoss	across
ballerine	ballerina
dpoungebob	spoungebob
getteng	getting
ti	to
h	a
vare	care
air	and
cs	is
ahe	the
carryinh	carrying
w	i
bust	busy
seack	black
ahs	has
doubla	double
it	is
shairs	chairs
satching	watching
dest	desk
muman	human
don'y	don't
an	in
am	an
sere	here
ab	an
teddi	teddy
lour's	your's
sust	just
wayer	water
sia	sea
screebs	screens
there	these
jird	bird
vwry	very
peet	feet
pippu	puppu
succwss	success
excape	escape
shaded	shades
re	to
dard	dark
dreswed	dressed
smoll	small
reacj	reach
w	i
millapsed	collapsed
rjre	here
bloves	gloves
eas	eat
wonan	woman
dor	for
deveral	several
roty	city
staft	start
axotic	exotic
frem	from
shoutet	shouted
iom	com
supern	superb
anytody	anybody
gears	hears
coney	honey
pictures	pictured
tath	bath
wauare	square
wlaking	walking
sids	sits
loveble	lovable
nther	other
on	in
wow	how
machinr	machine
thes	this
ahe	the
ny	by
slso	also
candli	candle
ond	and
mu	my
filhter	fighter
beautyfyl	beautifyl
woul	will
t	i
alove	above
enjouing	enjoying
whe	she
ly	my
pley	play
osean	ocean
nad	and
motorsycle	motorcycle
spide	pride
rollow	yellow
performatce	performance
dreplets	droplets
lettermand	lettermans
ataircase	staircase
hoke	joke
tind	wind
wfter	after
tto	too
s	a
sometne	someone
gags	bags
tour	your
fo	my
anqique	antique
nen	men
it	is
ever	even
coloreul	colorful
sencn	sense
torough	through
peebles	pebbles
arastic	plastic
cun	iun
qlephant	elephant
berd	bird
isidge	bridge
seomone	someone
soo	too
himan	human
wwere	where
ir's	it's
f	a
roaclights	roadlights
vovered	covered
obly	only
gild	gilr
sigting	sitting
roid	road
stick	stink
majic	magic
institure	institute
woman'	womans
cuiest	cutest
mlick	click
form	from
onliokers	onlookers
fon'	don'
firlds	fields
if	of
wain	rain
myddy	muddy
ino	two
dont	don'
vlue	blue
chructure	structure
fle	are
rpad	road
tot	not
rhe	the
handke	handle
food	good
lamo	lamp
and	all
deswrted	deserted
froots	fruits
ans	and
biver	river
refrected	reflected
desarable	desirable
boars	board
umbrelll	umbrella
lraves	leaves
rearing	wearing
growds	crowds
aold	sold
covesed	covered
earle'	eagle'
in	on
ohis	this
vocered	covered
earing	eating
earking	barking
pirple	purple
thate	those
beard	heard
ahe	the
coen'	aren'
standsng	standing
oir	our
wt	it
it	is
aid	did
spear	speak
orande	orange
muy	may
suitd	suits
van	can
plaiyng	playing
r	a
atairs	stairs
powet	power
fgag	flag
buklding	building
smaches	smashes
againit	against
rere	rare
there	these
volour	colour
bedrrom	bedroom
foil	fall
ant	any
aad	and
sitewalk	sidewalk
shat	what
it	in
sup	cup
emply	empty
dt	it
dont	don'
loojing	looking
elabprate	elaborate
fan	man
as	is
plying	flying
perosn	person
stock	stuck
fron	from
scartered	scattered
totending	extending
dries	dried
lobe	love
suitease	suitcase
uos	ups
nomber	number
snoe	snow
ciecus	circus
mappest	happest
weel	feel
clicled	clicked
billiarrz	billiards
freech	french
persone	persons
aet	set
thw	the
blonfe	blonde
budhs	budha
bule	blue
freaming	dreaming
tr	is
retween	between
wxperience	experience
ae	me
misdle	middle
tou	you
tith	with
knows	known
brabcges	branches
goog	good
dragongly	dragonfly
witj	with
ar	or
biddle	middle
rhe	the
kove	love
movnent	movment
rusic	music
wow	how
ab	an
picure	piture
heeds	needs
beaytiful	beautiful
fitizen	citizen
onny	only
holl	holy
unter	under
carera	camera
golded	folded
beaugiful	beautiful
palying	playing
tes	yes
coild	coold
siged	sized
men	man
golding	holding
pat	pet
sumway	subway
mawish	jewish
tp	up
joles	holes
on	in
had	has
lefs	legs
heu	hey
kake	lake
rige	ride
aea	sea
think	thing
ny	my
a	s
paking	taking
shouid	should
ahe	she
gruits	fruits
adverture	adventure
citting	sitting
haok	took
estulators	esculators
sdie	side
thina	china
wisket	wicket
a	i
obvects	objects
prown	brown
eill	kill
insede	inside
groung	ground
oiture	piture
easuly	easily
arms	arm'
ady	day
vaccums	vacuums
sas	was
doeked	docked
buy	guy
renttd	rented
sre	are
fee	sea
an	in
mew	new
beacj	beach
peoson	person
ny	by
oyack	black
gorm	form
seaeon	season
iee	see
t	i
thke	like
boarf	board
gumming	humming
rea	red
diffivult	difficult
beautifyl	beautiful
hugh	high
halding	holding
jur	car
chd	and
tou	you
tou	you
firl	girl
watk	walk
buch	much
awo	two
ahe	the
liry	very
iften	often
overlookiug	overlooking
territoru	territory
feflection	reflection
ahow	show
birl	girl
pickure	picture
ti	to
everuthing	everything
kaugh	laugh
walkigh	walkimh
uoung	young
toger	tiger
beauase	becuase
ilert	alert
bap	cap
froit	fruit
nuilding	building
thet	that
acticities	activities
enhoy	enjoy
waitiig	waiting
agsinst	against
palp	palm
wirh	wish
fithters	fighters
struped	striped
mammm	mammy
fiding	riding
dringing	drinking
iether	either
vaves	waves
anythink	anything
buulding	building
whule	while
horze	horse
sill	hill
clearing	cleaning
clivfs	cliffs
skills	skulls
wnfront	infront
had	has
cee	see
gukhinf	gushinf
aith	with
onthr	onthe
oid	old
tunner	tunnel
ahere	there
betrol	petrol
deffodil	daffodil
obkect	object
th	to
fice	five
taces	races
buke	bike
a	f
ppol	pool
arams	trams
rusiness	business
landdoun	landdown
camers's	camera's
asth	with
bhe	the
retting	getting
lloking	looking
inly	only
bachground	background
grouo	group
pe	te
scenin	scenic
van	can
bacl	back
i	a
kooking	looking
gor	for
tushes	pushes
bn	in
fhoto	photo
th	at
ses	sea
rice	nice
extravagant	extravegant
enjooing	enjoying
slass	glass
afreid	afraid
leag	leaf
upsode	upside
homr	home
aink	pink
makeng	making
wokan	woman
fromt	front
go	fo
same	save
witer	white
ihis	this
feoden	wooden
huyp	hump
a	i
layaks	kayaks
teapups	teacups
stant	stand
thmething	something
hoiky	hocky
vlean	clean
heautiful	beautiful
mpo	ppo
beautirul	beautiful
nive	nice
grak	drak
espaping	escaping
so	is
thes	this
nyself	myself
reash	reach
sujrounded	surrounded
tellow	yellow
eater	water
alephant	elephant
fweet	sweet
us	is
serced	served
admosphre	atmosphre
ciscuits	biscuits
tike	like
karge	large
gow	how
bibrary's	library's
on	in
joyly	jolly
dinishh	finishh
on	in
snlw	snow
ippears	appears
piblic	public
boxt	next
ky	my
don'y	don't
sored	bored
tre	are
graped	draped
hew	her
sxooty	scooty
w	a
uttlity	utility
clouses	cloudes
mt	my
bhite	white
tip	top
dhis	this
z	a
is	in
fli	fly
fof	for
misdle	middle
pitting	putting
anf	and
wated	water
stulosh	stylosh
tellow	yellow
loarned	learned
tip	top
beack	beach
stinding	standing
showung	showing
poat	post
crackert	crackers
form	from
creai	cream
nitht	night
lig	lit
beautirully	beautifully
gross	cross
i	u
forl	fork
shodows	shadows
happt	happy
arranements	arragements
soneone	someone
euppet	puppet
pf	of
thinkinh	thinking
anher	other
amall	small
rescur	rescue
thsh	fish
solding	holding
dpad	ipad
kepp	keep
u	i
congused	confused
oby	boy
libe	live
tpy	toy
cete	cute
leaces	leaves
r	t
grals	grass
frineds	friends
luxirious	luxurious
wlaking	walking
me	be
ahe	the
boatd	board
ypung	young
uith	with
amd	and
leadu	leady
af	of
aut	but
uou	you
lea	gel
thr	the
ip	up
in	on
teady	ready
thw	the
setective	detective
cimig	comig
in	to
ofer	over
wanr	want
salphie	ralphie
nhis	this
hooror	horror
ahere	there
paplr	paper
stbstance	substance
car	cat
wtat	what
eyed	eyes
sre	are
latrarn	lantarn
mungers	singers
mammu	mammy
metween	between
chei	chai
in	is
fac	fae
ant	and
stande	stands
effak	effal
is	it
oft	out
boar	boat
an	on
birl	girl
ang	and
ah	th
ih	in
fell	feel
aeaf	leaf
lrt	let
friot	fruit
ohoto	photo
dook	book
hg	hy
bied	bird
monkter	monster
b	a
st	in
heve	have
soving	moving
mais	this
in	on
bycycle	bicycle
and	end
ballois	ballons
muself	myself
golding	holding
strawwerries	strawberries
abandones	abandoned
peiple	people
perdons	persons
it	is
tith	with
weating	wearing
bulit	built
graxzing	grazzing
hoese	horse
oear	near
ran	fan
axpecting	expecting
eacg	each
jailes	jailed
mr	me
orom	from
anf	and
coule	could
tale	take
tunes	lines
matbe	maybe
atarted	started
exchangind	exchanging
yoe	are
wood	good
h	i
whtn	when
slight	flight
baching	bathing
jan	man
boar	boat
arvered	covered
mr	me
feeld	feels
soue	sore
hild	hold
youjg	young
ls	is
ion't	don't
iuti	buti
ma	my
eash	each
ealking	walking
ylying	laying
in	on
ahe	the
hacket	jacket
sere	here
behide	beside
alaying	playing
tglcome	welcome
top	toy
migaratte	cigaratte
heman's	human's
and	are
hb	ib
bug	big
te	me
prrud	proud
ward	yard
bot	not
haue	have
wnd	and
ire	are
pumpkimns	pumpkinns
tow	how
boars	boats
lokking	looking
flowerr	flowers
helicoiter	helicopter
dady	lady
prople	people
sayong	saying
clinb	climb
frower	flower
raedy	ready
dreak	break
byning	buying
jand	hand
nostrils	nostrill
dwner	owner
oaaa	haaa
blown	brown
tou	toy
plact	place
tapeup	takeup
wgite	white
het	hey
h	i
aeading	reading
cealing	ceeling
fool	cool
site	side
zmazing	amazing
yo	to
froup	group
withouo	without
in	on
in	on
boxeng	boxing
throygh	through
trandiose	grandiose
aongregrate	congregrate
dnto	into
bu	by
butause	because
beanh	beach
to	go
dolored	colored
ao	to
hyman	human
celearly	cclearly
betwwen	between
walkind	walking
live	love
th	no
wyat	what
thort	short
waithng	waiting
hop	top
inuipments	equipments
wor	for
btone	stone
ddanosure	dianosure
sime	time
rines	lines
lint	want
fling	going
picutres	pictures
eith	with
bood	good
hrart	heart
wases	waves
drimi	drumi
tider	rider
an	on
playinf	playing
amn	man
dooo	door
wnly	only
playimg	playing
an	in
kven	even
comm	come
staral	spiral
colling	cooking
relieg	relief
streer	street
funcyion	function
prve	give
un	in
sn	an
cabe	cage
differenc	different
dolden	golden
sead	dead
ak	at
us	is
ihis	this
w	i
in	to
dee	see
cooton	cotton
anybofy	anybody
in	on
scultpure	sculpture
don	dog
sn	in
ezam	exam
throght	through
talent	talest
sead	read
weeing	seeing
prepipice	precipice
allti	multi
thrwe	three
s	a
wow	how
sliff	cliff
sn	on
painying	painting
to	do
flting	flying
tear	near
af	of
hundry	hungry
wekl	well
have	hate
youody	nobody
autside	outside
waking	wlking
ia	is
unddr	under
dreesing	dressing
ihe	the
an	in
siom	from
lookid	looked
beautidul	beautiful
wioomin	gloomin
lank	land
bedrrom	bedroom
rarth	earth
mow	now
foing	going
ahall	shall
flyes	flies
cather	father
an	on
bintage	vintage
husband	husbend
surreunded	surrounded
s	a
spped	speed
citewalk	sidewalk
thisg	thing
weis	this
olates	plates
uou	you
pieve	piece
seallow	swallow
os	of
birs	bird
brar	near
commng	coming
hoie	home
tany	many
lead	leaf
whish	which
an	am
re	me
vert	very
embanknent	embankment
bpwl	bowl
berrier	berries
fail	fall
atanding	standing
maching	machine
breac	break
tith	with
weth	with
plating	playing
ditting	sitting
ond	and
wtih	with
lig	lit
eveyign	evenign
somr	some
rears	tears
cau	can
id	is
oneards	onwards
w	o
sidturb	disturb
thet	that
avtivities	activities
os	is
on	in
bhe	the
chicolate	chocolate
slags	flags
fiolet	violet
san'	don'
same	some
js	is
fhe	the
soing	doing
amomg	among
gonna	going
behace	behave
hean	jean
cought	caught
olides	oldies
ski	sky
t	i
wjat	what
buiduing	building
majic	magic
itation	station
trynks	trunks
refrects	reflects
uou	you
aery	very
hoe	how
naskets	baskets
rhair	chair
cee	see
sercer	sercet
streee	street
there	their
wrezze	brezze
sant	sanu
ckme	some
seautiful	beautiful
glying	flying
a	i
mopents	moments
wmokes	smokes
l	a
hiil	hill
kike	like
theyr	their
by	my
courtolding	courholding
theuty	baeuty
aust	just
nejoying	enjoying
of	or
f'	i'
amosgst	amongst
how	now
dangeruus	dangerous
everypeoson	everyperson
ytnned	tanned
fgis	this
ewins	twins
pork	park
gelmet	helmet
beople	people
staiding	standing
can't	don't
coll	kill
ahohwing	shohwing
outsoors	outdoors
dunnt	sunnt
glasees	glasses
befine	behine
curface	surface
bires	birds
lerniture	furniture
seimming	swimming
come	came
remembur	remember
ihere	where
lettle	kettle
rpbe	robe
wasier	easier
mosourful	colourful
fenquin	penquin
lf	of
roys	toys
clurred	blurred
class	glass
women	woman
sum	sun
jpy	joy
lit	lot
yelloe	yellow
nest	next
todat	today
maw	now
bamk	bank
cooton	cotton
iut	but
yoo	too
wwll	well
alwo	also
bridgr	bridge
sare	dare
anciant	ancient
stip	stop
dor	for
toung	young
amy	any
t	a
thing	think
bycucle	bycycle
wothout	without
as	is
yhote	whote
dinhs	dinks
pwoplw	people
m	a
lightssuse	lighthouse
plating	playing
uou	you
bool	pool
haal	hall
lge	age
it	my
ahile	while
th	is
rea	red
sake	take
os	as
phoyograph	photograph
thibks	thinks
beggnning	beginning
kids	kind
aver	over
mand	mans
aeay	reay
tith	with
purole	purple
laby	lady
donete	donate
anr	for
noamal	normal
con'	can'
m	i
coke	coca
uou	you
sloating	floating
shriped	striped
tlaying	playing
vegitables	vegetables
horst	horse
avenie	avenue
sycle	cycle
enkoy	enjoy
tre	are
slanding	standing
nubmer	number
lighti	lights
food	good
cracyand	crazyand
bet	get
hld	old
og	of
come	some
sleeoing	sleeping
caughy	caught
asts	acts
cloads	clouds
humm	hums
ir	i'
behing	behind
fullen	fallen
winnwr	winner
hostital	hospital
communers	commuters
relationshis	relationship
cploured	coloured
thinm	think
throun	thrown
l	i
lollopy	jollopy
studies	studied
forgoe	forgot
mome	some
rocj	rock
thicks	tricks
sut	sit
pwrsons	persons
sriend	friend
r	i
cradhing	crashing
alouds	clouds
law	low
wtrawberry	strawberry
fress	dress
raxi	taxi
remenber	remember
plat	play
pmage	image
coluorful	colourful
contemplateng	contemplating
seople	people
blidge	bridge
soutee	souted
cpatured	captured
climding	climbing
om	on
as	is
s	a
bud	bug
ypur	your
miought	thought
buidling	building
donoy	donot
he	hi
runnin	runnig
treen	green
wates	waves
scenery	scenary
combinatiom	combination
fnly	only
in	on
withoug	without
wonen	women
triditional	traditional
marson	person
buie	boie
elelashers	eyelashers
lag	leg
rach	each
ohoto	photo
os	is
nwing	swing
motorcylce	motorcycle
girldore	girlwore
davorite	favorite
mnre	more
yhe	the
stsrving	starving
weres	wires
what	that
lweet	sweet
poys	boys
atar	near
worse	horse
birf	bird
bridhe	bridge
ghe	the
pictures	pictured
od	of
lihe	like
wubbles	bubbles
liitle	little
prette	pretty
daiting	waiting
walds	walks
blowrng	blowing
on	in
sll	all
habe	have
lhristmas	christmas
neat	near
teo	two
vree	free
escelator	escilator
sjy	sky
ao	am
firl	girl
visivle	visible
sell	cell
k	a
ln	in
flar	flag
dedign	design
fir	fit
plies	plays
blieish	blueish
lrngth	length
wy	by
ahit	whit
swaying	playing
proyd	proud
drumisy	drumist
their	thier
peaning	leaning
wjat	what
fore	more
alaborate	elaborate
woran	woman
lropped	dropped
tou	toy
to	in
grog	frog
slasses	glasses
crow	crew
c	a
deserttd	deserted
affaid	afraid
putterfly	butterfly
wea	sea
incect	insect
dave	save
for	soi
pairin	pierin
thite	white
dor	for
beaugifully	beautifully
plaved	placed
advertistment	advertisement
waithng	waiting
ignero	ignore
ausic	music
growwing	grooming
theiy	their
blacket	blanket
wrok	work
borielia	borielis
fith	with
enouth	enough
cutved	carved
instrunent	instrument
bascet	basket
fense	fence
is	it
bicylcl	bicylce
landad	landed
pinish	punish
passpart	passport
tear	near
salking	walking
sothing	nothing
waitimg	waiting
nhe	the
parjed	parked
matchimg	matching
hs	is
io	is
threwing	throwing
womng	young
horser	horses
bangle	single
fig	big
cirarette	cigarette
jumpimg	jumping
rice	rive
whaterer	whatever
drees	dress
hos	his
togrther	together
cirious	curious
givblets	gibblets
poing	doing
soe	the
an	am
veritable	vegitable
ans	and
taci	taxi
lite	cute
ix	is
wphere	sphere
mai	man
are't't	are'n't
swin	swim
faiting	waiting
slaid	plaid
firls	girls
come	some
wat	way
actife	active
ted	ied
gigl	girl
facourite	favourite
kids	kiss
muct	must
the	tip
bycacle	bicycle
hell	full
lioking	looking
bujldings	buildings
t	i
ans	and
yeange	orange
iu	it
artowrk	artwork
lacated	located
beautyful	beautiful
cime	some
heve	have
reeding	reading
af	of
trre	tree
florers	flowers
ligtle	little
trup	trip
struugling	struggling
kam	iam
waterfull	waterfall
ho	to
sish	fish
fine	wine
clock	block
waithng	waiting
wys	eys
gairest	fairest
lounch	lounge
tred	tied
blye	blue
thider	spider
grom	from
accooss	acrooss
ne	me
sress	dress
photographe	photographs
accoss	across
tte	the
rainint	raininy
quitely	quietly
parkeng	parking
meace	place
peaple	people
tine	time
wsy	esy
pedestrua	pedestria
singibg	singing
strret	street
scuplture	sculpture
wondows	windows
farm	form
bbautiful	beautiful
nalloons	balloons
aolding	holding
leded	leged
eart	ealy
ate	are
stlye	style
samele	sample
out	our
enjoying	enjoyind
fo	do
looke	locke
gorup	group
dau	day
romove	remove
in	on
og	of
rivering	riveting
colplete	complete
dovered	covered
ahat	that
an	on
iner	ther
behing	behind
an	am
fhoulder	shoulder
con't	don't
ehildren	children
atripes	stripes
wiyh	with
safe	save
few	dew
pkan	plan
rhe	the
way	was
sie	she
comong	coming
midern	modern
she	the
artifucially	artificially
liok	look
chat	that
io	to
as	in
skeep	sleep
prosucts	products
pwrson	person
your	you'
ordidee	orhidee
mmm	hmm
stratching	stretching
ctothes	clothes
wmoen	women
footwall	football
hald	half
cuty	city
pide	pipe
yourseld	yourself
statur	statue
an	to
lives	lines
dind	find
treen	green
t	a
sourond	sorrond
ststue	statue
standong	standing
beautifyl	beautiful
bicysle	bicycle
jusp	jump
blle	blue
gin'	won'
vwhicles	vehicles
rake	take
toghther	together
oener	owner
carnivek	carnivel
someiting	something
bwtween	between
is	it
barmer	farmer
it	at
lokking	looking
ie	we
enjayable	enjoyable
ohe	the
tey	try
abondonned	abandonned
if	of
mike	like
aroung	around
pemonstrate	demonstrate
iere	were
kike	like
nerer	never
oll	all
fwesome	awesome
foofball	foodball
my	me
griend's	friend's
will	with
roc	red
mn	in
berk	park
pigions	pigeons
unifirm	uniform
fireworkd	fireworks
af	of
keke	make
peopls	people
bipe	pipe
buliding	building
yhy	why
deadh	death
perpaps	perhaps
wathr	water
amoke	smoke
shininh	shining
outisde	outside
wiong	along
slone	alone
dieam	dream
in	to
newr	near
ovean	ocean
hands	hangs
supportsrs	supporters
t	a
ciat	coat
os	of
vidw	view
dair	hair
cull	full
freind	friend
lee	let
iook	look
t'm	i'm
whowing	showing
s	a
bery	very
ltreet	street
beauyiful	beautiful
dod	dog
buy	guy
tith	with
mw	me
sharer	shaker
thiuk	think
iren'	aren'
wa	he
nove	move
in	on
ruaying	playing
eoman	woman
locus	lotus
subewy	subway
chrich	chruch
sayd	says
mt	my
ir	it
thos	this
ebtrence	entrence
siperb	superb
tode	tide
di	do
whth	with
copples	cupples
torards	towards
aow	how
slack	black
on	in
fhat	what
boman	woman
fxtreme	extreme
vlue	blue
icow	snow
alwayd	always
enhine	engine
gravel	travel
walke	walks
plople	people
dome	some
heir	hair
id	is
stanging	standing
feeld	field
lids	kids
tennes	tennis
t	a
gheatest	greatest
thai	thei
one	onn
smeels	smells
tne	one
eith	with
site	side
sre	are
oer	our
nust	must
gind	find
qho	who
yoy	you
pigens	pigons
oyher	other
eid	bid
oglyest	uglyest
yhe	the
co	go
toe	the
is	in
suckijg	sucking
notive	notice
ahe	the
dap	cap
eitht	eight
rea	red
ilay	play
on	in
turtre	turtle
woocen	wooden
ab	an
theough	through
hie	the
beaitiful	beautiful
hot	not
swemming	swimming
tjis	this
iner	over
bictcles	bicycles
pull	full
wich	with
veach	beach
aeople	people
dearhi	deathi
strret	street
ao	so
camers	camera
petal	metal
like	make
utinal	urinal
bevause	because
hts	its
perpendicular	perpindicular
wn	on
btanch	branch
crasehd	crashed
wnjoy	enjoy
oy	my
tris	this
vaking	taking
mhis	this
iw	am
tumprt	tumpet
at	as
fry	dry
megision	megesion
ane	one
of	on
behch	bench
an	on
poosessed	possessed
cept	kept
favourate	favourite
flkte	flute
backgroung	background
severe	sevier
wnder	under
fresses	dresses
seimming	swimming
ana	wna
hiliday	holiday
lever	cover
parge	large
osmething	something
ald	old
bike	like
yoj	you
tome	some
elughter	daughter
tat	eat
spought	thought
gry	try
blossems	blossams
ar	at
flyinfinto	flyinginto
ans	and
w	a
brange	orange
vrom	from
shw	she
pyking	making
croosing	crossing
maek	miek
geat	gear
im	am
in	on
wiew	view
bools	books
id	is
empth	empty
soll	poll
noard	board
yo	to
wan	van
my	me
sodtumes	costumes
feelimg	feeling
sompleted	completed
can	van
wonfdr	wonder
smnll	small
t	a
tlue	blue
townlouses	townhouses
fave	face
paas	pass
men's	man's
aox	fox
cacated	vacated
bobble	bubble
chins	china
iave	have
fays	days
teaves	leaves
beigh	beige
expressiom	expression
avove	above
leman	lemon
sity	city
xk	co
umghted	lighted
sean	seen
roace	place
gor	for
sone	some
imidst	amidst
fress	dress
koney	honey
kying	lying
sity	city
iey	hey
th	to
vs	is
ornage	orange
thwards	towards
on	in
faying	flying
eggg	eggs
ls	is
sown	down
shandelier	chandelier
